Company,Budget,Director,Profit,Star,Month,Writer,Gross
Columbia Pictures Corporation,8000000,Rob Reiner,44287414,Wil Wheaton,8,Stephen King,52287414
Paramount Pictures,6000000,John Hughes,64136369,Matthew Broderick,6,John Hughes,70136369
Paramount Pictures,15000000,Tony Scott,164800601,Tom Cruise,5,Jim Cash,179800601
Twentieth Century Fox Film Corporation,18500000,James Cameron,66660248,Sigourney Weaver,7,James Cameron,85160248
Walt Disney Pictures,9000000,Randal Kleiser,9564613,Joey Cramer,8,Mark H. Baker,18564613
Hemdale,6000000,Oliver Stone,132530565,Charlie Sheen,2,Oliver Stone,138530565
Henson Associates (HA),25000000,Jim Henson,-12270083,David Bowie,6,Dennis Lee,12729917
De Laurentiis Entertainment Group (DEG),6000000,David Lynch,2551228,Isabella Rossellini,10,David Lynch,8551228
Paramount Pictures,9000000,Howard Deutch,31471663,Molly Ringwald,2,John Hughes,40471663
SLM Production Group,15000000,David Cronenberg,25456565,Jeff Goldblum,8,George Langelaan,40456565
Rimfire Films,8800000,Peter Faiman,165835000,Paul Hogan,9,Ken Shadie,174635000
Thorn EMI Screen Entertainment,16000000,Russell Mulcahy,-10100000,Christopher Lambert,3,Gregory Widen,5900000
Twentieth Century Fox Film Corporation,6000000,David Seltzer,2200000,Corey Haim,3,David Seltzer,8200000
Twentieth Century Fox Film Corporation,25000000,John Carpenter,-13900000,Kurt Russell,7,Gary Goldman,11100000
De Laurentiis Entertainment Group (DEG),15000000,Michael Mann,-6379071,William Petersen,8,Thomas Harris,8620929
Producers Sales Organization (PSO),17000000,Adrian Lyne,-10265156,Mickey Rourke,2,Elizabeth McNeill,6734844
De Laurentiis Entertainment Group (DEG),10000000,Stephen King,-2566337,Emilio Estevez,7,Stephen King,7433663
Geffen Company The,25000000,Frank Oz,13747385,Rick Moranis,12,Howard Ashman,38747385
New Century Entertainment Corporation,2700000,Mike Marvin,800000,Charlie Sheen,11,Mike Marvin,3500000
Universal Pictures,35000000,Willard Huyck,-18704226,Lea Thompson,8,Steve Gerber,16295774
New Line Cinema,2000000,Stephen Herek,11167232,Dee Wallace,4,Domonic Muir,13167232
Orion Pictures,11000000,Alan Metter,80258000,Rodney Dangerfield,6,Rodney Dangerfield,91258000
Cannon Films,4700000,Tobe Hooper,3325872,Dennis Hopper,8,L.M. Kit Carson,8025872
Jay Weston Productions,15000000,Clint Eastwood,27724017,Clint Eastwood,12,James Carabatsos,42724017
Paramount Pictures,25000000,Leonard Nimoy,84713132,William Shatner,11,Gene Roddenberry,109713132
Paramount Pictures,25000000,Michael Ritchie,54817937,Eddie Murphy,12,Dennis Feldman,79817937
Hemdale,1900000,Tim Hunter,2700000,Crispin Glover,5,Neal Jimenez,4600000
L.A. Films,25000000,John Landis,14246734,Steve Martin,12,Steve Martin,39246734
Warner Bros.,25000000,George P. Cosmatos,24042224,Sylvester Stallone,5,Paula Gosling,49042224
Warner Bros.,24500000,Roland Joffé,-7281977,Robert De Niro,10,Robert Bolt,17218023
Touchstone Pictures,13800000,Martin Scorsese,38493982,Paul Newman,10,Walter Tevis,52293982
HBO Films,6000000,Robert Harmon,-155132,Rutger Hauer,2,Eric Red,5844868
Amblin Entertainment,10000000,Richard Benjamin,27499651,Tom Hanks,3,David Giler,37499651
Paramount Pictures,3000000,Tom McLoughlin,16472057,Thom Mathews,8,Tom McLoughlin,19472057
The Saul Zaentz Company,25000000,Peter Weir,-10697221,Harrison Ford,11,Paul Theroux,14302779
Initial Pictures,4000000,Alex Cox,-1173477,Gary Oldman,11,Alex Cox,2826523
De Laurentiis Entertainment Group (DEG),10000000,John Guillermin,-5288780,Brian Kerwin,12,Ronald Shusett,4711220
Empire Pictures,4500000,Stuart Gordon,-3239000,Jeffrey Combs,10,H.P. Lovecraft,1261000
TriStar Pictures,18000000,Francis Ford Coppola,23382841,Kathleen Turner,10,Jerry Leichtling,41382841
Freddie Fields Productions,19000000,Brian Gibson,21996665,JoBeth Williams,5,Mark Victor,40996665
Empire Pictures,1100000,John Carl Buechler,4350815,Michael Moriarty,1,Ed Naha,5450815
Maljack Productions,111000,John McNaughton,498939,Michael Rooker,9,Richard Fire,609939
ABC Motion Pictures,18000000,Harry Winer,-8302261,Kate Capshaw,6,Clifford Green,9697739
Orion Pictures,6400000,Woody Allen,33684041,Mia Farrow,3,Woody Allen,40084041
Walt Disney Pictures,14000000,Ron Clements,24600000,Vincent Price,7,Peter Young,38600000
De Laurentiis Entertainment Group (DEG),8500000,John Irvin,7709459,Arnold Schwarzenegger,6,Luciano Vincenzoni,16209459
Sunbow Productions,6000000,Nelson Shin,-150353,Orson Welles,8,Ron Friedman,5849647
TriStar Pictures,5000000,Fred Dekker,-4408634,Jason Lively,8,Fred Dekker,591366
Cannon Pictures,12000000,Tobe Hooper,-7115337,Karen Black,6,Richard Blake,4884663
De Haven Productions,6000000,David Anspaugh,22607524,Gene Hackman,2,Angelo Pizzo,28607524
Cinema '85,6500000,James Foley,-4153000,Sean Penn,4,Elliott Lewitt,2347000
Paramount Pictures,20000000,Mike Nichols,5314289,Meryl Streep,7,Nora Ephron,25314289
Warner Bros.,15000000,Michael Chapman,-13046268,Daryl Hannah,1,Jean M. Auel,1953732
Golan-Globus Productions,12000000,Menahem Golan,5768900,Chuck Norris,2,James Bruner,17768900
Paramount Pictures,18000000,Ron Howard,18611610,Michael Keaton,3,Edwin Blum,36611610
40 Acres & A Mule Filmworks,175000,Spike Lee,6962502,Tracy Camilla Johns,8,Spike Lee,7137502
Delphi V Productions,8700000,Paul Michael Glaser,-3834088,Stephen Lang,4,Leo Garen,4865912
Columbia Pictures Corporation,12000000,Mark L. Lester,3945534,John Candy,8,Brian Grazer,15945534
Black Snake,1100000,Jim Jarmusch,336000,Tom Waits,10,Jim Jarmusch,1436000
Orion Pictures,10000000,Robert Mandel,10603715,Bryan Brown,2,Robert T. Megginson,20603715
Gladden Entertainment,18000000,Marshall Brickman,-14100000,John Lithgow,6,Marshall Brickman,3900000
Paramount Pictures,5000000,Fred Walton,7947763,Deborah Foreman,3,Danilo Bach,12947763
Brooksfilms,25000000,Alan Johnson,-23420740,Richard Jordan,11,Walon Green,1579260
Carthago Films S.a.r.l.,40000000,Roman Polanski,-38358175,Walter Matthau,7,John Brownjohn,1641825
Touchstone Pictures,10000000,Jeff Kanew,11458229,Burt Lancaster,10,James Orr,21458229
Cinema Group Ventures,12000000,Roger Spottiswoode,-4209069,Robin Williams,1,Ron Shelton,7790931
Paragon Arts International,2000000,Kevin Tenney,5369373,Todd Allen,3,Kevin Tenney,7369373
Touchstone Pictures,14000000,Paul Mazursky,48134225,Nick Nolte,1,René Fauchois,62134225
Capital Equipment Leasing,8500000,Trevor Nunn,-8222354,Helena Bonham Carter,2,Chris Bryant,277646
Producers Sales Organization (PSO),18000000,Hal Ashby,-16694886,Jeff Bridges,4,Lawrence Block,1305114
Cannon Group,8000000,J. Lee Thompson,3834302,Chuck Norris,11,Robert Gosnell,11834302
Amaretto Films,3300000,Richard Wenk,1641117,Chris Makepeace,7,Donald P. Borchers,4941117
Warner Bros.,15000000,Harold Ramis,-2691479,Robin Williams,7,Harry Shearer,12308521
Universal Pictures,40000000,Ivan Reitman,9851591,Robert Redford,6,Ivan Reitman,49851591
Metro-Goldwyn-Mayer (MGM),13000000,Brian De Palma,-4524534,Danny DeVito,4,George Gallo,8475466
HandMade Films,17000000,Jim Goddard,-14684317,Sean Penn,8,John Kohn,2315683
Lorimar Productions,16000000,Sidney Lumet,-12200000,Richard Gere,1,David Himmelstein,3800000
De Laurentiis Entertainment Group (DEG),20000000,Bruce Beresford,2905500,Diane Keaton,1,Beth Henley,22905500
Golan-Globus Productions,6000000,J. Lee Thompson,3947631,Charles Bronson,4,Gail Morgan Hickman,9947631
Cannon Group The,4000000,Sam Firstenberg,679650,Michael Dudikoff,9,James Booth,4679650
Rastar Pictures,18000000,Gene Saks,-6042057,Blythe Danner,12,Neil Simon,11957943
De Laurentiis Entertainment Group (DEG),25000000,Daryl Duke,-20992750,Bryan Brown,11,John Briley,4007250
Escalante Productions,17000000,Dick Richards,-14206786,Burt Reynolds,3,William Goldman,2793214
Columbia Pictures Corporation,14000000,Richard Pryor,4034150,Richard Pryor,5,Rocco Urbisci,18034150
Cinema Group Ventures,3401376,Renny Harlin,-13356,Mike Norris,8,Renny Harlin,3388020
Paramount Pictures,10000000,Michelle Manning,-3052213,Judd Nelson,5,Ross Macdonald,6947787
American Playhouse,2000000,Jerrold Freedman,-698879,Victor Love,12,Richard Wesley,1301121
J&M; Entertainment,18000000,Zoran Perisic,-15704500,Scott McGinnis,10,Thom Keyes,2295500
Cinetel Films,1500000,Fred Olen Ray,-131088,David Carradine,10,T.L. Lankford,1368912
Act III Communications,16000000,Rob Reiner,14857814,Cary Elwes,10,William Goldman,30857814
Cinemarque Entertainment BV,1000000,Clive Barker,13564027,Andrew Robinson,9,Clive Barker,14564027
Natant,30000000,Stanley Kubrick,16357676,Matthew Modine,7,Gustav Hasford,46357676
Great American Films Limited Partnership,6000000,Emile Ardolino,57952836,Patrick Swayze,8,Eleanor Bergstein,63952836
Amercent Films,15000000,John McTiernan,44735548,Arnold Schwarzenegger,6,Jim Thomas,59735548
Braveworld Productions,27000000,Paul Michael Glaser,11122105,Arnold Schwarzenegger,11,Stephen King,38122105
Brooksfilms,22700000,Mel Brooks,15419483,Mel Brooks,6,Mel Brooks,38119483
Orion Pictures,13000000,Paul Verhoeven,40424681,Peter Weller,7,Edward Neumeier,53424681
Warner Bros.,15000000,Richard Donner,50207127,Mel Gibson,3,Shane Black,65207127
Paramount Pictures,25000000,Brian De Palma,51270454,Kevin Costner,6,Oscar Fraley,76270454
De Laurentiis Entertainment Group (DEG),3600000,Sam Raimi,2323044,Bruce Campbell,3,Sam Raimi,5923044
Golan-Globus Productions,22000000,Gary Goddard,-4663630,Dolph Lundgren,8,David Odell,17336370
Home Box Office (HBO),12000000,Fred Dekker,-8230010,Andre Gower,8,Shane Black,3769990
Paramount Pictures,14000000,Adrian Lyne,142645693,Michael Douglas,9,James Dearden,156645693
Eon Productions,30000000,John Glen,21185897,Timothy Dalton,7,Richard Maibaum,51185897
Twentieth Century Fox Film Corporation,15000000,Oliver Stone,28848100,Charlie Sheen,12,Stanley Weiser,43848100
Amblin Entertainment,35000000,Steven Spielberg,-12761304,Christian Bale,12,Tom Stoppard,22238696
Warner Bros.,22000000,George Miller,41766510,Jack Nicholson,6,John Updike,63766510
New Line Cinema,4500000,Chuck Russell,40293222,Heather Langenkamp,2,Wes Craven,44793222
Universal Pictures,23000000,Joseph Sargent,-2236987,Lorraine Gary,7,Peter Benchley,20763013
Cannon Group,25000000,Menahem Golan,-8942420,Sylvester Stallone,2,Gary Conway,16057580
Paramount Pictures,30000000,John Hughes,19530280,Steve Martin,11,John Hughes,49530280
Circle Films,6000000,Joel Coen,16847564,Nicolas Cage,4,Ethan Coen,22847564
Carolco International N.V.,17000000,Alan Parker,185632,Mickey Rourke,3,William Hjortsberg,17185632
Gladden Entertainment,6000000,Michael Gottlieb,36721196,Andrew McCarthy,2,Edward Rugoff,42721196
Warner Bros.,27000000,Joe Dante,-1106190,Dennis Quaid,7,Chip Proser,25893810
Metro-Goldwyn-Mayer (MGM),15000000,Norman Jewison,65640528,Cher,1,John Patrick Shanley,80640528
Paramount Pictures,28000000,Tony Scott,125665000,Eddie Murphy,5,Danilo Bach,153665000
Recorded Picture Company (RPC),23000000,Bernardo Bertolucci,20984230,John Lone,4,Mark Peploe,43984230
Touchstone Pictures,13000000,Barry Levinson,110922370,Robin Williams,1,Mitch Markowitz,123922370
Merchant Ivory Productions,2600000,James Ivory,530592,James Wilby,9,E.M. Forster,3130592
Interscope Communications,11000000,Leonard Nimoy,156780960,Tom Selleck,11,Coline Serreau,167780960
Alive Films,3000000,John Carpenter,11182492,Donald Pleasence,10,John Carpenter,14182492
Columbia Pictures Corporation,6500000,Luis Valdez,47715416,Lou Diamond Phillips,7,Luis Valdez,54215416
F/M,5000000,Kathryn Bigelow,-1630693,Adrian Pasdar,6,Kathryn Bigelow,3369307
Orion Pictures,15000000,Roger Donaldson,20509515,Kevin Costner,8,Kenneth Fearing,35509515
Amercent Films,20000000,James L. Brooks,31249404,William Hurt,12,James L. Brooks,51249404
New Century Entertainment Corporation,2500000,Tibor Takács,11039458,Stephen Dorff,5,Michael Nankin,13539458
Cannon Films,17000000,Sidney J. Furie,-1318980,Christopher Reeve,7,Joe Shuster,15681020
Laurel Entertainment Inc.,3500000,Michael Gornick,10500000,George Kennedy,5,Stephen King,14000000
Atlantic Entertainment Group,3000000,Christopher Leitch,4888703,Jason Bateman,11,Jeph Loeb,7888703
Columbia Pictures Industries,12000000,Fred Schepisi,28050884,Steve Martin,6,Edmond Rostand,40050884
Rastar Pictures,12000000,Herbert Ross,54995879,Michael J. Fox,4,Jim Cash,66995879
Applied Action,20000000,Tom Mankiewicz,37387516,Dan Aykroyd,6,Dan Aykroyd,57387516
TriStar Pictures,18000000,Blake Edwards,21321715,Kim Basinger,3,Dale Launer,39321715
Atlantic Entertainment Group,1000000,Rod Amateau,576615,Anthony Newley,8,Linda Palmer,1576615
Orion Pictures,14000000,Danny DeVito,43915972,Danny DeVito,12,Stu Silver,57915972
Golan-Globus Productions,3000000,Barbet Schroeder,221568,Mickey Rourke,10,Charles Bukowski,3221568
Universal Pictures,6000000,Phil Joanou,-2314138,Casey Siemaszko,10,Richard Christian Matheson,3685862
Amercent Films,15000000,James Toback,-1709632,Molly Ringwald,9,James Toback,13290368
Orion Pictures,16000000,Woody Allen,-1207221,Mia Farrow,1,Woody Allen,14792779
Emshell Producers,3000000,John R. Cherry III,20509382,Jim Varney,5,John R. Cherry III,23509382
Columbia Pictures Corporation,17000000,Ridley Scott,-6721451,Tom Berenger,10,Howard Franklin,10278549
Universal Pictures,29000000,Richard Attenborough,-23100203,Denzel Washington,11,John Briley,5899797
Fourth Protocol,6000000,John Mackenzie,6423831,Michael Caine,8,George Axelrod,12423831
Home Box Office (HBO),27000000,Hector Babenco,-19606654,Jack Nicholson,2,William Kennedy,7393346
Cannon Group,5000000,J. Lee Thompson,1880310,Charles Bronson,11,Brian Garfield,6880310
Amercent Films,18000000,Jonathan Kaplan,532286,Matthew Broderick,4,Lawrence Lasker,18532286
Cannon Films,4000000,Ruggero Deodato,-3200000,David Paul,3,Alberto Piferi,800000
Columbia Pictures Corporation,55000000,Elaine May,-40624819,Warren Beatty,5,Elaine May,14375181
Conquering Unicorn,100000,Robert Townsend,5128617,Robert Townsend,3,Robert Townsend,5228617
Carolco Entertainment,22000000,Walter Hill,-10692156,Nick Nolte,4,John Milius,11307844
Cannon Group,350000,Sam Firstenberg,3650000,Michael Dudikoff,5,Gary Conway,4000000
Cinecom Entertainment Group,4000000,John Sayles,-2319642,Chris Cooper,6,John Sayles,1680358
Columbia Pictures,24000000,Paul Weiland,-19083129,Bill Cosby,12,Jonathan Reynolds,4916871
Golan-Globus Productions,5000000,Jerry Schatzberg,-3880888,Christopher Reeve,3,David Freeman,1119112
Gladden Entertainment,9000000,Michael Cimino,-3593121,Christopher Lambert,10,Mario Puzo,5406879
De Laurentiis Entertainment Group (DEG),7000000,Bob Giraldi,19441,Jon Cryer,11,Joe Menosky,7019441
Orion Pictures,10000000,Harley Cokeliss,-6939142,Burt Reynolds,5,Christopher Frank,3060858
Samuel Goldwyn Company The,6000000,Mike Hodges,-4567313,Mickey Rourke,9,Jack Higgins,1432687
Columbia Pictures,5300000,Michael Radford,-2192449,Sarah Miles,5,James Fox,3107551
Rollins-Joffe Productions,10000000,Woody Allen,-9513566,Elaine Stritch,12,Woody Allen,486434
Independent Film Centre,3520000,Lance Hool,-2957813,Patrick Swayze,3,Doug Lefler,562187
Empire Pictures,1300000,Renny Harlin,-945296,Lane Smith,12,Irwin Yablans,354704
Warner Bros.,25000000,Martin Ritt,5950002,Barbra Streisand,12,Tom Topor,30950002
Bandai Films,11000000,Barry Levinson,14411386,Richard Dreyfuss,3,Barry Levinson,25411386
De Laurentiis Entertainment Group (DEG),7500000,William Friedkin,-6703632,Michael Biehn,10,William P. Wood,796368
Vista Organization,3000000,Amy Holden Jones,6868521,Ally Sheedy,7,Amy Holden Jones,9868521
Commies From Mars Corporation,1000000,Alex Cox,-789800,Sy Richardson,6,Alex Cox,210200
Silent Night Releasing Corporation,100000,Lee Harry,54323,Eric Freeman,4,Michael Hickey,154323
De Laurentiis Entertainment Group (DEG),8000000,Tom McLoughlin,-6011038,Phoebe Cates,11,Tom McLoughlin,1988962
In-Cine Compañía Industrial Cinematográfica,5800000,Alex Cox,-5542957,Ed Harris,12,Rudy Wurlitzer,257043
TriStar Pictures,19000000,Roger Young,-16771049,Michael Keaton,7,Daniel Taplitz,2228951
Golan-Globus Productions,5000000,Peter R. Hunt,1075793,Charles Bronson,1,Richard Sale,6075793
Titan Productions,75000,David DeCoteau,-61867,Linnea Quigley,10,Dave Eisenstark,13133
TriStar Pictures,12000000,Robert Benton,-6330169,Jeff Bridges,8,Robert Benton,5669831
Conquest Productions,1100000,Jeff Burr,255728,Vincent Price,9,C. Courtney Joyner,1355728
Golan-Globus Productions,5000000,Norman Mailer,-4141750,Ryan O'Neal,9,Norman Mailer,858250
New World Entertainment Films,4000000,Bill Condon,-3256555,Eric Stoltz,2,Bill Condon,743445
Cannon Group,15000000,Jerry Belson,-9288024,Sally Field,10,Jerry Belson,5711976
Paramount Pictures,14000000,Michael Apted,6240502,Richard Pryor,1,Denis Hamill,20240502
De Laurentiis Entertainment Group (DEG),12000000,John D. Hancock,-9674556,Nick Nolte,10,Dorothy Tristan,2325444
Geffen Company The,15000000,Tim Burton,58707461,Alec Baldwin,3,Michael McDowell,73707461
Eddie Murphy Productions,39000000,John Landis,89152300,Eddie Murphy,6,Eddie Murphy,128152300
United Artists,9000000,Tom Holland,24244684,Catherine Hicks,11,Don Mancini,33244684
Twentieth Century Fox Film Corporation,28000000,John McTiernan,55008852,Bruce Willis,7,Roderick Thorp,83008852
Metro-Goldwyn-Mayer (MGM),35000000,Ron Howard,22269863,Val Kilmer,5,George Lucas,57269863
New World Pictures,3000000,Michael Lehmann,-1891538,Winona Ryder,3,Daniel Waters,1108462
United Artists,25000000,Barry Levinson,147825435,Dustin Hoffman,12,Barry Morrow,172825435
Alive Films,4000000,John Carpenter,9008928,Roddy Piper,11,Ray Nelson,13008928
Touchstone Pictures,70000000,Robert Zemeckis,86452370,Bob Hoskins,6,Gary K. Wolf,156452370
American Entertainment Partners II L.P.,18000000,Penny Marshall,96968774,Tom Hanks,6,Gary Ross,114968774
Touchstone Pictures,20000000,Roger Donaldson,58222753,Tom Cruise,7,Heywood Gould,78222753
Cristaldifilm,5000000,Giuseppe Tornatore,6990401,Philippe Noiret,2,Giuseppe Tornatore,11990401
TriStar Pictures,19000000,Chuck Russell,-10752057,Shawnee Smith,8,Theodore Simonson,8247943
De Laurentiis Entertainment Group (DEG),3500000,Stan Winston,885516,Lance Henriksen,1,Ed Justin,4385516
Metro-Goldwyn-Mayer (MGM),7500000,Charles Crichton,55993712,John Cleese,8,John Cleese,63493712
Sarlui / Diamant,2000000,Stephen Chiodo,13625095,Grant Cramer,5,Charles Chiodo,15625095
Universal Pictures,30000000,Martin Brest,8413606,Robert De Niro,7,George Gallo,38413606
Film Futures,3000000,Tony Randel,8090735,Doug Bradley,12,Clive Barker,11090735
Orion Pictures,15000000,Alan Parker,19603943,Gene Hackman,1,Chris Gerolmo,34603943
Paramount Pictures,12000000,David Zucker,66041829,Leslie Nielsen,12,Jerry Zucker,78041829
Cannon International,1100000,Newt Arnold,10706119,Jean-Claude Van Damme,4,Sheldon Lettich,11806119
Twentieth Century Fox Film Corporation,28000000,Mike Nichols,36000000,Melanie Griffith,12,Kevin Wade,64000000
Paramount Pictures,14000000,John Cornell,95305000,Paul Hogan,5,Paul Hogan,109305000
Universal Pictures,12500000,Don Bluth,35592846,Pat Hingle,11,Stu Krieger,48092846
Universal Pictures,15000000,Ivan Reitman,96936400,Arnold Schwarzenegger,12,William Davies,111936400
Lorimar Film Entertainment,14000000,Stephen Frears,20700000,Glenn Close,2,Christopher Hampton,34700000
The Saul Zaentz Company,17000000,Philip Kaufman,-6993194,Daniel Day-Lewis,2,Milan Kundera,10006806
Trancas International Films,5000000,Dwight H. Little,12768757,Donald Pleasence,10,Dhani Lipsius,17768757
Morgan Creek Productions,13000000,Christopher Cain,32661556,Emilio Estevez,8,John Fusco,45661556
Carolco Pictures,29000000,Walter Hill,5994648,Arnold Schwarzenegger,6,Walter Hill,34994648
Night Life Inc.,6000000,Donald Petrie,6793213,Annabeth Gish,10,Amy Holden Jones,12793213
Carolco Pictures,63000000,Peter MacDonald,-9284389,Sylvester Stallone,5,David Morrell,53715611
Paramount Pictures,6000000,Jonathan Kaplan,26069318,Kelly McGillis,10,Tom Topor,32069318
Universal Pictures,7000000,Martin Scorsese,630564,Willem Dafoe,3,Nikos Kazantzakis,7630564
New Line Cinema,2000000,John Waters,4671108,Sonny Bono,2,John Waters,6671108
New Line Cinema,13000000,Renny Harlin,36369899,Robert Englund,8,Wes Craven,49369899
Hughes Entertainment,24000000,Howard Deutch,17455230,Dan Aykroyd,6,John Hughes,41455230
The Mount Company,7000000,Ron Shelton,43888729,Kevin Costner,6,Ron Shelton,50888729
Warner Bros.,7500000,Andrew Davis,11369631,Steven Seagal,4,Andrew Davis,18869631
De Laurentiis Entertainment Group (DEG),10000000,Julien Temple,-6083697,Geena Davis,5,Julie Brown,3916303
Walt Disney Feature Animation,31000000,George Scribner,43151346,Joey Lawrence,11,Jim Cox,74151346
Warner Bros.,31000000,Buddy Van Horn,6903295,Clint Eastwood,7,Harry Julian Fink,37903295
NBC Productions,7500000,James Signorelli,-1903733,Cassandra Peterson,9,Sam Egan,5596267
Paramount Pictures,32000000,Richard Donner,28328558,Bill Murray,11,Mitch Glazer,60328558
Cinema City Films,23000000,Robert Towne,18292551,Mel Gibson,12,Robert Towne,41292551
Warner Bros.,20000000,Roman Polanski,-2362050,Harrison Ford,2,Roman Polanski,17637950
Paramount Pictures,2800000,John Carl Buechler,16370001,Jennifer Banko,5,Daryl Haney,19170001
Twentieth Century Fox Film Corporation,8000000,Greg Beeman,14433275,Corey Haim,7,Neil Tolkin,22433275
Prominent Features,46630000,Terry Gilliam,-38546877,John Neville,3,Charles McKeown,8083123
Morgan Creek Productions,13000000,David Cronenberg,-3865267,Jeremy Irons,9,David Cronenberg,9134733
Metro-Goldwyn-Mayer (MGM),10500000,Gary Sherman,3614488,Heather O'Rourke,6,Gary Sherman,14114488
Vista Organization,7500000,Tommy Lee Wallace,-4516216,William Ragsdale,5,Tom Holland,2983784
Front Films,3000000,Keenen Ivory Wayans,10030057,Keenen Ivory Wayans,2,Keenen Ivory Wayans,13030057
Zacharias-Buhai Productions,22000000,Bud S. Smith,-4449601,Anthony Michael Hall,3,Steve Zacharias,17550399
Shapiro-Glickenhaus Entertainment,1100000,William Lustig,-428618,Tom Atkins,5,Larry Cohen,671382
Orion Pictures,10000000,Jonathan Demme,11486757,Michelle Pfeiffer,8,Barry Strugatz,21486757
Orion Pictures,6000000,Dennis Hopper,40616067,Sean Penn,4,Michael Schiffer,46616067
Vision PDG,17000000,Neil Jordan,-8421769,Peter O'Toole,11,Neil Jordan,8578231
Double Play,3000000,Sidney Lumet,-164884,River Phoenix,9,Naomi Foner,2835116
Blue Rider Pictures,1200000,Kevin Tenney,1909904,Cathy Podewell,10,Joe Augustyn,3109904
Mac and Me Joint Venture,13000000,Stewart Raffill,-6575888,Christine Ebersole,8,Stewart Raffill,6424112
New Line Cinema,4500000,Mick Garris,-686707,Scott Grimes,4,David Twohy,3813293
Weintraub Entertainment Group,20000000,Richard Benjamin,-6146000,Dan Aykroyd,12,Jerico,13854000
Lorimar Film Entertainment,6200000,Ken Wiederhorn,3005924,James Karen,1,Ken Wiederhorn,9205924
Universal Pictures,22000000,Michael Apted,2720479,Sigourney Weaver,10,Harold T.P. Hayes,24720479
Magellan Pictures,2000000,Robert Bierman,-1274869,Nicolas Cage,6,Joseph Minion,725131
White Lair,2500000,Ken Russell,-1310685,Amanda Donohoe,10,Ken Russell,1189315
Universal Pictures,7000000,Wes Craven,12595031,Bill Pullman,2,Wade Davis,19595031
Columbia Pictures Corporation,5000000,Ken Annakin,-1430061,Tami Erin,7,Astrid Lindgren,3569939
Orion Pictures,6000000,John Sayles,-319485,John Cusack,9,Eliot Asinof,5680515
New Sky Communications Inc.,4700000,Frank LaLoggia,-2994861,Lukas Haas,4,Frank LaLoggia,1705139
Laurenfilm,700000,Pedro Almodóvar,6479298,Carmen Maura,11,Pedro Almodóvar,7179298
Spacegate Productions,3000000,Don Coscarelli,4282851,James Le Gros,7,Don Coscarelli,7282851
United Artists,25000000,James Bridges,-8881923,Michael J. Fox,4,Jay McInerney,16118077
Orion Pictures,7000000,George A. Romero,-1655423,Jason Beghe,7,Michael Stewart,5344577
Cornelius Productions,19000000,George Roy Hill,6537221,Chevy Chase,6,Jay Cronley,25537221
American Entertainment Partners II L.P.,16000000,Graham Baker,9216243,James Caan,10,Rockne S. O'Bannon,25216243
Lorimar Film Entertainment,7000000,Craig R. Baxley,13257000,Carl Weathers,2,Robert Reneau,20257000
Esparza,22000000,Robert Redford,-8174206,Rubén Blades,3,John Nichols,13825794
Lucasfilm,23000000,Francis Ford Coppola,-3347362,Jeff Bridges,8,Arnold Schulman,19652638
Columbia Pictures Corporation,6500000,Spike Lee,8045844,Laurence Fishburne,2,Spike Lee,14545844
Hemdale,3700000,Steve De Jarnatt,-2554596,Anthony Edwards,5,Steve De Jarnatt,1145404
Zanuck/Brown Productions,17500000,Daniel Petrie,1424919,Don Ameche,11,David Saperstein,18924919
Producers Representative Organization,4000000,Martin Donovan,-3329226,Hart Bochner,9,Martin Donovan,670774
Jack Rollins & Charles H. Joffe Productions,10000000,Woody Allen,-8437251,Gena Rowlands,11,Woody Allen,1562749
Malpaso Company The,9000000,Clint Eastwood,-6818714,Forest Whitaker,9,Joel Oliansky,2181286
Cannon Entertainment,15000000,Fred Schepisi,-8091203,Meryl Streep,11,John Bryson,6908797
Rastar Pictures,20000000,Mike Nichols,23184798,Matthew Broderick,3,Neil Simon,43184798
Cineplex-Odeon Films,4000000,Oliver Stone,-531428,Eric Bogosian,1,Stephen Singular,3468572
Guber-Peters Company The,20000000,Allan Arkush,-8201698,Jackie Mason,7,Brian Doyle-Murray,11798302
Imagine Entertainment,18000000,Ken Kwapis,-16116189,Cyndi Lauper,8,Deborah Blum,1883811
United Artists,19000000,Costa-Gavras,6816139,Debra Winger,8,Joe Eszterhas,25816139
Abramoff Production,16000000,Joseph Zito,-11807560,Dolph Lundgren,4,Robert Abramoff,4192440
Aspen Film Society,6000000,Paul Golding,-5959603,Cliff De Young,3,Paul Golding,40397
Weintraub Entertainment Group,14000000,David Anspaugh,-7359654,Molly Ringwald,11,Larry Ketron,6640346
Helpern / Meltzer,5000000,Mark Goldblatt,-1411374,Treat Williams,6,Terry Black,3588626
Miracle Pictures,210000,Jim Wynorski,-102648,Traci Lords,5,R.J. Robertson,107352
Columbia Pictures Corporation,15000000,Richard Benjamin,-13266930,Sidney Poitier,3,John Hill,1733070
Columbia Pictures Corporation,15000000,David Seltzer,6032267,Sally Field,10,David Seltzer,21032267
Hemdale,8000000,Harold Becker,-7215010,James Woods,12,Ben Stein,784990
Universal Pictures,20000000,Paul Mazursky,-8555796,Richard Dreyfuss,9,Charles G. Booth,11444204
Touchstone Pictures,6000000,John R. Cherry III,22202109,Jim Varney,11,Ed Turner,28202109
Atlantic Entertainment Group,3000000,James B. Harris,-1115685,James Woods,3,James Ellroy,1884315
Warner Bros.,4000000,Joan Micklin Silver,12262415,Amy Irving,9,Susan Sandler,16262415
Shapiro-Glickenhaus Entertainment,6000000,James Glickenhaus,4068039,Peter Weller,5,James Glickenhaus,10068039
Orion Pictures,19000000,Michael Ritchie,-7994696,Dan Aykroyd,1,Ken Kolb,11005304
Paramount Pictures,8000000,Marisa Silver,-6106861,Alan Boyce,4,Jarre Fees,1893139
TriStar Pictures,6000000,Pen Densham,-4130852,Joanna Pacula,10,Tom Ropelewski,1869148
Touchstone Pictures,14000000,Leonard Nimoy,-9235394,Diane Keaton,11,Michael Bortman,4764606
Cecchi Gori Group Tiger Cinematografica,19000000,Blake Edwards,-14405548,Bruce Willis,4,Rod Amateau,4594452
Cinema Group,1000000,Rowdy Herrington,-507481,James Spader,5,Rowdy Herrington,492519
HandMade Films,5000000,Nicolas Roeg,-4570972,Theresa Russell,7,Dennis Potter,429028
No Frills Film Production,4000000,Andrew Fleming,5797098,Jennifer Rubin,4,Andrew Fleming,9797098
Silver Screen Partners III,13000000,Chris Columbus,-7490583,David Keith,9,Chris Columbus,5509417
TriStar Pictures,18000000,Ted Kotcheff,-8870001,Kathleen Turner,3,Ben Hecht,9129999
Orion Pictures,14000000,Peter Yates,-13540176,Kelly McGillis,3,Walter Bernstein,459824
Crescent Moon,13000000,Peter Bogdanovich,-12740981,Rob Lowe,5,Michael Kaplan,259019
Cinetel Films,5000000,Steve Carver,-4192053,Gary Busey,3,T.L. Lankford,807947
Metro-Goldwyn-Mayer (MGM),12000000,Henry Winkler,-8034396,Billy Crystal,10,Eric Roth,3965604
Cinetel Films,1600000,Michael Schroeder,-1180572,Cameron Dye,5,J. Greg De Felice,419428
Smart Egg Pictures,7000000,Armand Mastroianni,-6863797,Cotter Smith,1,Gary Brandner,136203
Touchstone Pictures,16400000,Peter Weir,79460116,Robin Williams,6,Tom Schulman,95860116
Warner Bros.,35000000,Tim Burton,216188924,Michael Keaton,6,Bob Kane,251188924
Paramount Pictures,11500000,Mary Lambert,45969179,Dale Midkiff,4,Stephen King,57469179
Paramount Pictures,48000000,Steven Spielberg,149171806,Harrison Ford,5,Jeffrey Boam,197171806
Walt Disney Pictures,40000000,Ron Clements,71543479,Jodi Benson,11,John Musker,111543479
Warner Bros.,55000000,Andrey Konchalovskiy,8408614,Sylvester Stallone,12,Randy Feldman,63408614
Silver Pictures,17000000,Rowdy Herrington,13050028,Patrick Swayze,5,R. Lance Hill,30050028
Warner Bros.,27000000,Jeremiah S. Chechik,44320000,Chevy Chase,12,John Hughes,71320000
De Laurentiis Entertainment Group (DEG),10000000,Stephen Herek,30485039,Keanu Reeves,2,Chris Matheson,40485039
Universal Pictures,40000000,Robert Zemeckis,78500000,Michael J. Fox,11,Robert Zemeckis,118500000
Twentieth Century Fox Film Corporation,70000000,James Cameron,-15538953,Ed Harris,8,James Cameron,54461047
Universal Pictures,15000000,John Hughes,51758538,John Candy,8,John Hughes,66758538
40 Acres & A Mule Filmworks,6500000,Spike Lee,21045445,Danny Aiello,7,Spike Lee,27545445
TriStar Pictures,18000000,Edward Zwick,8830000,Matthew Broderick,2,Kevin Jarre,26830000
Castle Rock Entertainment,16000000,Rob Reiner,76823600,Billy Crystal,7,Nora Ephron,92823600
Columbia Pictures Corporation,37000000,Ivan Reitman,75494738,Bill Murray,6,Dan Aykroyd,112494738
TriStar Pictures,7500000,Amy Heckerling,132588813,John Travolta,10,Amy Heckerling,140088813
Filmauro,25000000,George P. Cosmatos,-9295386,Peter Weller,3,David Webb Peoples,15704614
Buena Vista Pictures,18000000,Joe Johnston,112724172,Rick Moranis,6,Stuart Gordon,130724172
Mirage Enterprises,11000000,David S. Ward,38797148,Tom Berenger,4,David S. Ward,49797148
Ixtlan,14000000,Oliver Stone,56001698,Tom Cruise,1,Ron Kovic,70001698
Imagine Entertainment,31000000,Ron Howard,69047830,Steve Martin,8,Lowell Ganz,100047830
Warner Bros.,28000000,Richard Donner,119253986,Mel Gibson,7,Jeffrey Boam,147253986
Danjaq,32000000,John Glen,2667015,Timothy Dalton,7,Michael G. Wilson,34667015
Universal Pictures,31000000,Steven Spielberg,12858790,Richard Dreyfuss,12,Jerry Belson,43858790
Outlaw Productions (I),1200000,Steven Soderbergh,23541700,James Spader,9,Steven Soderbergh,24741700
Norman Twain Productions,10000000,John G. Avildsen,21906454,Morgan Freeman,3,Michael Schiffer,31906454
Paramount Pictures,27800000,William Shatner,24410049,William Shatner,6,Gene Roddenberry,52210049
Zanuck Company The,7500000,Bruce Beresford,99093296,Morgan Freeman,1,Alfred Uhry,106593296
David Foster Productions,10000000,Graeme Clifford,-7222720,Christian Slater,1,Michael Tolkin,2777280
Columbia Pictures Corporation,22500000,Brian De Palma,-3828683,Michael J. Fox,8,Daniel Lang,18671317
TriStar Pictures,18000000,Arthur Hiller,28908987,Richard Pryor,5,Earl Barret,46908987
Kings Road Entertainment,1500000,Mark DiSalle,13197005,Jean-Claude Van Damme,9,Mark DiSalle,14697005
New Line Cinema,6000000,Stephen Hopkins,16168359,Robert Englund,8,Wes Craven,22168359
Magnum Pictures Inc.,3000000,Dominique Othenin-Girard,8642254,Donald Pleasence,10,John Carpenter,11642254
Paramount Pictures,5000000,Rob Hedden,9343976,Jensen Daggett,7,Rob Hedden,14343976
Eddie Murphy Productions,30000000,Eddie Murphy,30864870,Eddie Murphy,11,Eddie Murphy,60864870
Paramount Pictures,30000000,Ridley Scott,16212055,Michael Douglas,9,Craig Bolotin,46212055
Goldcrest Films International,13800000,Don Bluth,13300027,Dom DeLuise,11,Don Bluth,27100027
Cannon Entertainment,500000,Albert Pyun,9666459,Jean-Claude Van Damme,4,Albert Pyun,10166459
Universal Pictures,8000000,Michael Ritchie,27150960,Chevy Chase,3,Gregory McDonald,35150960
Finnegan/Pinchuk Productions,6000000,Todd Holland,8278900,Fred Savage,12,David Chisholm,14278900
Renaissance Films,9000000,Kenneth Branagh,1161099,Kenneth Branagh,11,William Shakespeare,10161099
Fries Entertainment,18000000,Jeff Kanew,-9491157,Shelley Long,3,Ava Ostern Fries,8508843
Universal Pictures,19000000,Harold Becker,39571513,Al Pacino,9,Richard Price,58571513
Movie Group The,5000000,Robert Radler,-3300000,Eric Roberts,11,Phillip Rhee,1700000
Renn Productions,33000000,Milos Forman,-31867888,Colin Firth,11,Choderlos de Laclos,1132112
Avenue Pictures,2500000,Gus Van Sant,2229352,Matt Dillon,10,James Fogle,4729352
New World Pictures,7000000,Steve Miner,2094451,Julian Sands,1,David Twohy,9094451
TMS Entertainment,35000000,Masami Hata,-33631790,Gabriel Damon,8,Chris Columbus,1368210
White Eagle,24000000,John Flynn,-1900153,Sylvester Stallone,8,Richard Smith,22099847
High Bar Productions,3000000,Jim Wheat,-2923675,Jillian McWhirter,11,Ken Wheat,76325
Cinecorp SAC,5000000,Jay Levey,1157157,'Weird Al' Yankovic,7,'Weird Al' Yankovic,6157157
Gladden Entertainment,13000000,Steve Kloves,3823529,Jeff Bridges,10,Steve Kloves,16823529
Palace Pictures,5000000,Zelda Barron,1957975,Phoebe Cates,7,Lanier Laney,6957975
Jack Rollins & Charles H. Joffe Productions,19000000,Woody Allen,-745298,Martin Landau,11,Woody Allen,18254702
JVC Entertainment Networks,2800000,Jim Jarmusch,-2432121,Masatoshi Nagase,11,Jim Jarmusch,367879
Carolco Entertainment,8000000,Sean S. Cunningham,143225,Greg Evigan,1,Lewis Abernathy,8143225
Alive Films,5000000,Wes Craven,11554699,Michael Murphy,10,Wes Craven,16554699
Touchstone Pictures,15000000,Francis Veber,25590000,Nick Nolte,1,Francis Veber,40590000
TriStar Pictures,10000000,Phillip Noyce,-7307963,Rutger Hauer,3,Ryôzô Kasahara,2692037
Lorimar Film Entertainment,12000000,John Irvin,3942628,Patrick Swayze,10,Michael Jenning,15942628
Touchstone Pictures,15000000,Woody Allen,-4236531,Woody Allen,3,Richard Price,10763469
Empire Pictures,10000000,Stuart Gordon,-8727023,Gary Graham,11,Stuart Gordon,1272977
Universal Pictures,15000000,Howard Zieff,13890240,Michael Keaton,4,Jon Connolly,28890240
Lightyear Entertainment,4000000,Jim Wynorski,-3807184,Dick Durock,5,Len Wein,192816
Paramount Pictures,20000000,Neil Jordan,-9444652,Robert De Niro,12,David Mamet,10555348
TriStar Pictures,16000000,Emile Ardolino,278590,Cybill Shepherd,3,Perry Howze,16278590
Carolco Pictures,20000000,Walter Hill,-12762206,Mickey Rourke,9,John Godey,7237794
Gordon Company,17000000,Rod Daniel,26247647,Jim Belushi,4,Steven Siegel,43247647
Malpaso Productions,19000000,Buddy Van Horn,-6856516,Clint Eastwood,5,John Eskow,12143484
New Line Cinema,8000000,Thomas J. Wright,8093651,Hulk Hogan,6,Dennis Hackin,16093651
Sean S. Cunningham Films,3000000,James Isaac,-1261103,Lance Henriksen,4,Allyn Warner,1738897
Warner Bros.,12000000,Peter Bonerz,-432783,Bubba Smith,3,Neal Israel,11567217
Amblin Entertainment,19000000,Gary David Goldberg,738015,Jack Lemmon,11,William Wharton,19738015
Paramount Pictures,13000000,Joel Schumacher,9030000,Ted Danson,2,Jean-Charles Tacchella,22030000
Allied Vision,5000000,Philippe Mora,-3080347,Christopher Walken,11,Whitley Strieber,1919653
Great American Films Limited Partnership,3000000,Bob Balaban,-2129468,Randy Quaid,1,Christopher Hawthorne,870532
Aspen Film Society,5000000,Christopher Guest,-4882537,Kevin Bacon,12,Michael Varhol,117463
Orion Pictures,18000000,Andrew Davis,-7352781,Gene Hackman,8,John Bishop,10647219
Paramount Pictures,18000000,Joe Pytka,-13026715,Richard Dreyfuss,8,Jay Cronley,4973285
Warner Bros.,18000000,Norman Jewison,-14468029,Emily Lloyd,9,Bobbie Ann Mason,3531971
American Playhouse,3000000,Norman René,1609953,Stephen Caffrey,5,Craig Lucas,4609953
Incorporated Television Company (ITC),4000000,John Dahl,-3716306,Val Kilmer,10,John Dahl,283694
Lorimar Film Entertainment,2300000,Michael Herz,-1507034,Ron Fazio,2,Lloyd Kaufman,792966
Larco Productions,2500000,Larry Cohen,-2456251,Bette Davis,2,Larry Cohen,43749
Incorporated Television Company (ITC),1500000,Jeff Burr,19796,Terry O'Quinn,11,Carolyn Lefcourt,1519796
Action Features,75000,Hal Hartley,471541,Adrienne Shelly,11,Action Features,546541
TriStar Pictures,11500000,Richard Baskin,-9239384,Lorraine Bracco,3,Dean Pitchford,2260616
Columbia Pictures Corporation,34000000,Luis Puenzo,-30425744,Jane Fonda,10,Carlos Fuentes,3574256
Cine Location Services,20000000,John Milius,-17579083,Nick Nolte,3,Pierre Schoendoerffer,2420917
AM/PM Entertainment,16000000,Robert Ellis Miller,-15932122,Brooke Shields,4,Noreen Stone,67878
Columbia Pictures Corporation,14000000,Jonathan Kaplan,-8067387,Glenn Close,10,Barbara Benedek,5932613
Columbia Pictures Corporation,17000000,Michael Crichton,-13439068,Burt Reynolds,1,Steve Ransohoff,3560932
American Playhouse Theatrical Films,4000000,Howard Brookner,-3956329,Josef Sommer,11,Howard Brookner,43671
Silver Screen Partners III,5000000,Jeff Blyth,3153677,Keith Coogan,8,Alan Caillou,8153677
Samuel Goldwyn Company The,6000000,Bill Forsyth,-4122382,Burt Reynolds,10,John Sayles,1877618
Columbia Pictures Corporation,26000000,Joel Schumacher,35490000,Kiefer Sutherland,8,Peter Filardi,61490000
Warner Bros.,25000000,Martin Scorsese,21836394,Robert De Niro,9,Nicholas Pileggi,46836394
Castle Rock Entertainment,20000000,Rob Reiner,41276872,James Caan,11,Stephen King,61276872
Carolco Pictures,65000000,Paul Verhoeven,54394840,Arnold Schwarzenegger,6,Philip K. Dick,119394840
Touchstone Pictures,14000000,Garry Marshall,164406268,Richard Gere,3,J.F. Lawton,178406268
Hughes Entertainment,18000000,Chris Columbus,267761243,Macaulay Culkin,11,John Hughes,285761243
Twentieth Century Fox Film Corporation,20000000,Tim Burton,36362352,Johnny Depp,12,Tim Burton,56362352
Paramount Pictures,54000000,Francis Ford Coppola,12666062,Al Pacino,12,Mario Puzo,66666062
Tig Productions,22000000,Kevin Costner,162208848,Kevin Costner,11,Michael Blake,184208848
Paramount Pictures,30000000,John McTiernan,92012643,Sean Connery,3,Tom Clancy,122012643
Universal Pictures,13000000,John Lafia,15501605,Alex Vincent,11,Don Mancini,28501605
Paramount Pictures,22000000,Jerry Zucker,195631306,Patrick Swayze,7,Bruce Joel Rubin,217631306
Universal Pictures,11000000,Ron Underwood,5667084,Kevin Bacon,1,S.S. Wilson,16667084
Warner Bros.,25000000,John Patrick Shanley,14404261,Tom Hanks,3,John Patrick Shanley,39404261
PolyGram Filmed Entertainment,9500000,David Lynch,5060247,Nicolas Cage,8,Barry Gifford,14560247
Carolco Pictures,25000000,Adrian Lyne,1118851,Tim Robbins,11,Bruce Joel Rubin,26118851
888 Productions,13500000,Steve Barron,121765915,Judith Hoag,3,Kevin Eastman,135265915
Hollywood Pictures,31000000,Frank Marshall,22208180,Jeff Daniels,7,Don Jakoby,53208180
Twentieth Century Fox Film Corporation,70000000,Renny Harlin,47540947,Bruce Willis,7,Walter Wager,117540947
Touchstone Pictures,47000000,Warren Beatty,56738726,Warren Beatty,6,Chester Gould,103738726
Universal Pictures,10000000,Dennis Dugan,43470900,Michael Oliver,7,Scott Alexander,53470900
Don Simpson/Jerry Bruckheimer Films,60000000,Tony Scott,22670733,Tom Cruise,6,Robert Towne,82670733
Universal Pictures,11000000,John Waters,-2733657,Johnny Depp,4,John Waters,8266343
Universal Pictures,40000000,Robert Zemeckis,47727583,Michael J. Fox,5,Robert Zemeckis,87727583
United Artists,42000000,John G. Avildsen,-1053642,Sylvester Stallone,11,Sylvester Stallone,40946358
Imagine Entertainment,26000000,Ivan Reitman,65457688,Arnold Schwarzenegger,12,Murray Salem,91457688
Davis Entertainment,35000000,Stephen Hopkins,-4330587,Danny Glover,11,Jim Thomas,30669413
Warner Bros.,36000000,George Miller,-18626473,Jonathan Brandis,2,Karin Howard,17373527
Orion Pictures,35000000,Irvin Kershner,10681173,Peter Weller,6,Edward Neumeier,45681173
Circle Films,14000000,Joel Coen,-8919591,Gabriel Byrne,10,Joel Coen,5080409
Twentieth Century Fox Film Corporation,40000000,Renny Harlin,-18586498,Andrew Dice Clay,7,Daniel Waters,21413502
Renaissance Pictures,16000000,Sam Raimi,17878502,Liam Neeson,8,Sam Raimi,33878502
Warner Bros.,22000000,Alan J. Pakula,64303188,Harrison Ford,7,Scott Turow,86303188
Warner Bros.,50000000,Joe Dante,-8517793,Zach Galligan,6,Chris Columbus,41482207
Morgan Creek Productions,11000000,Clive Barker,-2137646,Craig Sheffer,2,Clive Barker,8862354
Orion Pictures,31000000,Richard Benjamin,4419397,Cher,12,Patty Dann,35419397
21st Century Film Corporation,4200000,Tom Savini,1635247,Tony Todd,10,John A. Russo,5835247
Paramount Pictures,3500000,John Harrison,12824573,Debbie Harry,5,Michael McDowell,16324573
Imperial Entertainment Corporation,3000000,Sheldon Lettich,21078196,Jean-Claude Van Damme,1,S.N. Warren,24078196
Warner Bros.,10000000,Bruce Malmuth,37410000,Steven Seagal,2,Steven McKay,47410000
Paramount Pictures,10500000,Ralph S. Singleton,1082891,David Andrews,10,Stephen King,11582891
Silver Screen Partners IV,30000000,Hendel Butoy,-2068539,Bob Newhart,11,Jim Cox,27931461
Morgan Creek Productions,20000000,Geoff Murphy,24143410,Emilio Estevez,8,John Fusco,44143410
Hudlin Brothers The,2500000,Reginald Hudlin,23886000,Christopher Reid,3,Reginald Hudlin,26386000
Lightning Pictures,5200000,Mark L. Lester,-2740105,Bradley Gregg,5,Mark L. Lester,2459895
Victor & Grais,12000000,Dwight H. Little,34044400,Steven Seagal,10,Michael Grais,46044400
Carolco Pictures,35000000,Roger Spottiswoode,-3946399,Mel Gibson,8,Christopher Robbins,31053601
Warner Bros.,10000000,Clint Eastwood,11633874,Clint Eastwood,12,Boaz Yakin,21633874
Pathé Entertainment,20000000,Simon Wincer,1413105,Tom Selleck,10,John Hill,21413105
Morgan Creek Productions,18000000,John Schlesinger,11381956,Melanie Griffith,9,Daniel Pyne,29381956
Warner Bros.,47000000,Brian De Palma,-31308808,Tom Hanks,12,Michael Cristofer,15691192
Ironbark Films,25000000,John Cornell,-18060054,Paul Hogan,12,Paul Hogan,6939946
Warner Bros.,12000000,Akira Kurosawa,-10036793,Akira Terao,8,Akira Kurosawa,1963207
Palace Pictures,1500000,Richard Stanley,4228953,Dylan McDermott,9,Steve MacManus,5728953
Enigma Productions,23000000,Michael Caton-Jones,4441977,Matthew Modine,10,Monte Merrick,27441977
Vision PDG,7000000,Craig R. Baxley,-2651632,Dolph Lundgren,9,Jonathan Tydor,4348368
Universal Pictures,20000000,John Badham,50980000,Mel Gibson,5,Louis Venosta,70980000
Dino De Laurentiis Company,18000000,Michael Cimino,-15257088,Mickey Rourke,10,Joseph Hayes,2742912
Paramount Pictures,38000000,Walter Hill,42818974,Eddie Murphy,6,Roger Spottiswoode,80818974
Columbia Pictures Corporation,22000000,Mike Nichols,15963281,Meryl Streep,9,Carrie Fisher,37963281
Devoted Productions,15000000,Howard Franklin,260154,Bill Murray,7,Jay Cronley,15260154
88 Productions,19000000,Jack Nicholson,-8994031,Jack Nicholson,8,Robert Towne,10005969
Cannon Films,4000000,Deran Sarafian,12853487,Jean-Claude Van Damme,9,David S. Goyer,16853487
Levins-Henenlotter,2500000,Frank Henenlotter,-2294932,James Lorinz,6,Robert Martin,205068
Laurence Mark Productions,20000000,James Orr,-4620747,Jim Belushi,10,James Orr,15379253
Universal Pictures,10000000,Spike Lee,6153600,Denzel Washington,8,Spike Lee,16153600
Metro-Goldwyn-Mayer (MGM),23000000,Martin Ritt,-17179985,Jane Fonda,2,Pat Barker,5820015
Nova International Films,22000000,David Green,-7239549,Nicolas Cage,5,Step Tyner,14760451
Epic Productions,7000000,Curtis Hanson,5626043,Rob Lowe,3,David Koepp,12626043
Recorded Picture Company (RPC),25000000,Bernardo Bertolucci,-22924916,Debra Winger,12,Paul Bowles,2075084
Mirage Enterprises,40000000,Sydney Pollack,-30756860,Robert Redford,12,Judith Rascoe,9243140
ADC Films,9000000,Dario Argento,-8650382,Adrienne Barbeau,10,Dario Argento,349618
Orion Pictures,12000000,Woody Allen,-4668353,Mia Farrow,1,Woody Allen,7331647
Malpaso Productions,24000000,Clint Eastwood,-21680876,Clint Eastwood,9,Peter Viertel,2319124
Westerly Films,225000,Whit Stillman,2713208,Carolyn Farina,8,Whit Stillman,2938208
Channel Four Films,700000,Hal Hartley,-343878,Adrienne Shelly,9,Hal Hartley,356122
Concorde Pictures,2000000,Adam Simon,-372045,Bill Pullman,1,Charles Beaumont,1627955
Interscope Communications,10000000,Robert Resnikoff,12424195,Lou Diamond Phillips,4,Robert Resnikoff,22424195
Silver Screen Partners IV,3000000,Patrick Read Johnson,12369573,Douglas Barr,4,Patrick Read Johnson,15369573
Concorde Pictures,350000,Sally Mattison,892995,Keely Christian,9,Catherine Cyran,1242995
TriStar Pictures,15000000,Bob Clark,-9414846,Gene Hackman,2,Richard Christian Matheson,5585154
Vision PDG,6500000,Tibor Takács,-4467027,Louis Tripp,2,Michael Nankin,2032973
The Mount Company,11500000,Roger Corman,-11165252,John Hurt,11,Brian Aldiss,334748
Cinemarque Entertainment,5000000,Michael Lehmann,-4514228,Ed Begley Jr.,2,Michael Lehmann,485772
Park-Schilling Productions Inc.,242000,Michael Rissi,-8850,Joe Estevez,10,Vivian Schilling,233150
Twentieth Century Fox Film Corporation,10000000,Richard Benjamin,-7653850,Anthony Edwards,1,Nat Mauldin,2346150
Haruki Kadokawa Films,42000000,Haruki Kadokawa,-41692225,Takaaki Enoki,2,Haruki Kadokawa,307775
Strong Heart/Demme Production,19000000,Jonathan Demme,111742922,Jodie Foster,2,Thomas Harris,130742922
Carolco Pictures,102000000,James Cameron,102843350,Arnold Schwarzenegger,7,James Cameron,204843350
Walt Disney Pictures,25000000,Gary Trousdale,193967620,Paige O'Hara,11,Linda Woolverton,218967620
Columbia Pictures Corporation,6500000,John Singleton,51004069,Cuba Gooding Jr.,7,John Singleton,57504069
Metro-Goldwyn-Mayer (MGM),30000000,Barry Sonnenfeld,83502000,Anjelica Huston,11,Charles Addams,113502000
Universal Pictures,11000000,Jon Avnet,71418501,Kathy Bates,1,Fannie Flagg,82418501
Amblin Entertainment,70000000,Steven Spielberg,49654823,Dustin Hoffman,12,J.M. Barrie,119654823
Largo Entertainment,24000000,Kathryn Bigelow,19218387,Patrick Swayze,7,Rick King,43218387
Pathé Entertainment,16500000,Ridley Scott,28861000,Susan Sarandon,5,Callie Khouri,45361000
Amblin Entertainment,35000000,Martin Scorsese,44100000,Robert De Niro,11,John D. MacDonald,79100000
Columbia Pictures Corporation,17000000,Howard Zieff,42847242,Anna Chlumsky,11,Laurice Elehwany,59847242
Warner Bros.,48000000,Kevin Reynolds,117500000,Kevin Costner,6,Pen Densham,165500000
Universal Pictures,13000000,Jack Bender,1960255,Justin Whalin,8,Don Mancini,14960255
Columbia Pictures Corporation,11000000,William A. Graham,-8192146,Brian Krause,8,Henry De Vere Stacpoole,2807854
Paramount Pictures,30000000,Nicholas Meyer,44888996,William Shatner,12,Gene Roddenberry,74888996
Warner Bros.,40000000,Oliver Stone,30405498,Kevin Costner,12,Oliver Stone,70405498
Circle Films,9000000,Joel Coen,-2846061,John Turturro,8,Joel Coen,6153939
Walt Disney Pictures,35000000,Joe Johnston,11704056,Billy Campbell,6,Dave Stevens,46704056
Recorded Picture Company (RPC),16000000,David Cronenberg,-13458459,Peter Weller,4,William S. Burroughs,2541541
Twentieth Century Fox Film Corporation,26000000,Jim Abrahams,43467617,Charlie Sheen,7,Jim Abrahams,69467617
Applied Action,40000000,Dan Aykroyd,-31520207,Chevy Chase,2,Peter Aykroyd,8479793
Universal Pictures,15000000,Brian Levant,10104700,John Ritter,7,Scott Alexander,25104700
Touchstone Pictures,35000000,Frank Oz,28710000,Bill Murray,5,Alvin Sargent,63710000
New Line Cinema,2500000,Gus Van Sant,3901336,River Phoenix,7,Gus Van Sant,6401336
Castle Rock Entertainment,27000000,Ron Underwood,97033791,Billy Crystal,6,Lowell Ganz,124033791
Bill Graham Films,38000000,Oliver Stone,-2816208,Val Kilmer,3,Randall Jahnson,35183792
TriStar Pictures,24000000,Terry Gilliam,17895491,Jeff Bridges,9,Richard LaGravenese,41895491
Geffen Pictures,29000000,Tony Scott,30509925,Bruce Willis,12,Shane Black,59509925
Imagine Films Entertainment,75000000,Ron Howard,2868585,Kurt Russell,5,Gregory Widen,77868585
Twentieth Century Fox Film Corporation,19000000,Joseph Ruben,82599005,Julia Roberts,2,Nancy Price,101599005
Universal Pictures,6000000,Wes Craven,18204154,Brandon Quintin Adams,11,Wes Craven,24204154
TriStar Pictures,10000000,Daniel Petrie Jr.,5073942,Sean Astin,4,William P. Kennedy,15073942
Warner Bros.,8500000,Mario Van Peebles,39124253,Wesley Snipes,3,Thomas Lee Wright,47624253
Golden Harvest Company,25000000,Michael Pressman,53656813,Paige Turco,3,Kevin Eastman,78656813
New Line Cinema,11000000,Rachel Talalay,23872033,Robert Englund,9,Wes Craven,34872033
TriStar Pictures,65000000,Michael Lehmann,-47781920,Bruce Willis,5,Bruce Willis,17218080
Interscope Communications,20000000,Peter Hewitt,18037513,Keanu Reeves,7,Chris Matheson,38037513
PolyGram Filmed Entertainment,6788000,Ate de Jong,37090334,Phoebe Cates,5,Elizabeth Livingston,43878334
Stone Group Pictures,15000000,Sheldon Lettich,15102717,Jean-Claude Van Damme,8,Sheldon Lettich,30102717
Victor Company of Japan (JVC),3500000,Jim Jarmusch,-1484190,Winona Ryder,12,Jim Jarmusch,2015810
Paramount Pictures,13500000,Stan Dragoti,12755594,Scott Bakula,9,Rick Natkin,26255594
Paramount Pictures,29000000,Garry Marshall,-6226465,Al Pacino,10,Terrence McNally,22773535
Joseph S. Vecchio Entertainment,35000000,John Landis,-11437284,Sylvester Stallone,4,Claude Magnier,23562716
TriStar Pictures,30000000,Barry Levinson,19114016,Warren Beatty,12,James Toback,49114016
Columbia Pictures Corporation,30000000,Barbra Streisand,44787599,Barbra Streisand,12,Pat Conroy,74787599
Paramount Pictures,23000000,David Zucker,63930411,Leslie Nielsen,6,Jim Abrahams,86930411
Arnold Kopelson Productions,14000000,John Flynn,25673161,Steven Seagal,4,R. Lance Hill,39673161
Universal Pictures,14000000,Spike Lee,18482682,Wesley Snipes,6,Spike Lee,32482682
Alive Films,6000000,David Kellogg,-4806938,Vanilla Ice,10,David Stenn,1193062
Paramount Pictures,50000000,Mike Nichols,-6998500,Harrison Ford,7,J.J. Abrams,43001500
Little Tokyo Productions,8000000,Mark L. Lester,-5724443,Dolph Lundgren,8,Stephen Glantz,2275557
Metro-Goldwyn-Mayer (MGM),17000000,Lili Fini Zanuck,-9758650,Jason Patric,1,Kim Wozencraft,7241350
Paramount Pictures,15000000,Kenneth Branagh,23016380,Kenneth Branagh,8,Scott Frank,38016380
Detour Filmproduction,23000,Richard Linklater,1205108,Richard Linklater,7,Richard Linklater,1228108
Davis-Panzer Productions,30000000,Russell Mulcahy,-14443660,Christopher Lambert,11,Gregory Widen,15556340
Hughes Entertainment,25000000,John Hughes,8691313,Jim Belushi,10,John Hughes,33691313
Goldcrest Films International,18000000,Don Bluth,-6342615,Glen Campbell,4,Don Bluth,11657385
Krisjair,23000000,Simon Wincer,-15565274,Mickey Rourke,8,Don Michael Paul,7434726
Walt Disney Pictures,14000000,Randal Kleiser,20793160,Ethan Hawke,1,Jack London,34793160
Universal Pictures,23000000,Michael Karbelnikoff,-2753210,Christian Slater,7,Michael Mahern,20246790
Stone Group Pictures,17000000,Craig R. Baxley,-7713686,Brian Bosworth,5,Walter Doniger,9286314
TriStar Pictures,17000000,Maurice Phillips,-14134084,Richard Pryor,7,Ziggy Steinberg,2865916
Orion Pictures,10000000,Jodie Foster,15010896,Jodie Foster,11,Scott Frank,25010896
Argos Films,23000000,Wim Wenders,-22247144,William Hurt,12,Peter Carey,752856
IRS Media,1400000,Bobcat Goldthwait,-1284897,Bobcat Goldthwait,3,Bobcat Goldthwait,115103
Columbia Pictures Corporation,8000000,Alan Rudolph,11018321,Demi Moore,4,William Reilly,19018321
Vista Street Entertainment,10000000,Eric Red,-811850,Jeff Fahey,8,Pierre Boileau,9188150
Capella International,22000000,Wolfgang Petersen,-10488969,Tom Berenger,10,Richard Neely,11511031
Brooksfilms,13000000,Mel Brooks,-8897474,Mel Brooks,7,Mel Brooks,4102526
Metro-Goldwyn-Mayer (MGM),18000000,Tom Mankiewicz,-12453173,John Candy,8,Lawrence J. Cohen,5546827
Columbia Pictures Corporation,7000000,Sean Penn,-6808875,David Morse,9,Sean Penn,191125
Baltimore Pictures,11000000,Steven Soderbergh,-9940929,Jeremy Irons,11,Lem Dobbs,1059071
Twentieth Century Fox Film Corporation,17000000,Peter Faiman,-12396071,Ed O'Neill,7,John Hughes,4603929
Touchstone Pictures,48000000,Robert Benton,-32034081,Dustin Hoffman,11,E.L. Doctorow,15965919
Cinetel Films,3000000,Marc Rocco,-2609848,Dermot Mulroney,9,Michael Hitchcock,390152
Palace Pictures,8000000,Bill Duke,2438504,Forest Whitaker,5,Chester Himes,10438504
Carolco Pictures,7500000,Martha Coolidge,-1233379,Laura Dern,9,Calder Willingham,6266621
Gladden Entertainment,13000000,Stewart Raffill,-9247574,Kristy Swanson,5,Edward Rugoff,3752426
Paramount Pictures,10000000,Mark DiSalle,4061361,Jeff Speakman,3,David C. Wilson,14061361
Pathé Entertainment,18000000,Nicholas Meyer,-16498215,Gene Hackman,9,Nicholas Meyer,1501785
Paramount Pictures,35000000,John Milius,-20412268,Danny Glover,1,Stephen Coonts,14587732
All Girl Productions,40000000,Mark Rydell,-22139720,Bette Midler,11,Neal Jimenez,17860280
Orion Pictures,14000000,Woody Allen,-11264269,Woody Allen,3,Woody Allen,2735731
Empire Pictures (II),2000000,Stuart Gordon,-1996669,Lance Henriksen,6,Edgar Allan Poe,3331
Hudlin Brothers The,5000000,George Jackson,14281235,Christopher Reid,10,Reginald Hudlin,19281235
The Saul Zaentz Company,36000000,Hector Babenco,-34657097,Tom Berenger,12,Peter Matthiessen,1342903
Hollywood Pictures,26000000,Jerry Rees,-13545232,Kim Basinger,4,Neil Simon,12454768
Sean Daniel Company,17010000,Nadia Tass,5631969,Martin Short,8,Francis Veber,22641969
Largo Entertainment,22000000,Rod Daniel,-10999137,Joe Pesci,10,Sam Simon,11000863
Orion Pictures,16400000,Richard Franklin,4682165,Bryan Brown,5,Robert T. Megginson,21082165
Films A2,28000000,Leos Carax,-27882431,Juliette Binoche,7,Leos Carax,117569
Bronze Eye Productions,250000,Todd Haynes,359524,Edith Meeks,8,Jean Genet,609524
Hollywood Pictures,16000000,Geoff Burrowes,-11590672,Patrick Dempsey,2,Dennis Shryack,4409328
Hollywood Pictures,4000000,Heywood Gould,7276846,Michael Keaton,5,Heywood Gould,11276846
Cinecom Entertainment Group,16000000,Lasse Hallström,-1148917,Richard Dreyfuss,2,Malia Scotch Marmo,14851083
Les Films 21,6000000,Sylvio Tabet,-5130675,Marc Singer,8,Andre Norton,869325
Orion Pictures,10000000,Jonathan Wacks,-3833181,Ethan Hawke,8,Parker Bennett,6166819
Imagine Entertainment,4000000,Radha Bharadwaj,-3740988,Madeleine Stowe,3,Radha Bharadwaj,259012
TriStar Pictures,10000000,Matthew Robbins,-1332316,Cindy Williams,8,Jim Strain,8667684
Nelson Entertainment,19000000,Sidney J. Furie,-18060723,Ken Wahl,10,Sidney J. Furie,939277
Juno Pix,1900000,Joseph B. Vasquez,-1367067,Doug E. Doug,4,Joseph B. Vasquez,532933
American Playhouse,450000,Matty Rich,2262293,George T. Odom,6,Matty Rich,2712293
Touchstone Pictures,3000000,Paul Mazursky,6563393,Bette Midler,2,Roger L. Simon,9563393
Esperanza Films Inc.,3000000,John Sayles,-1735090,Vincent Spano,11,John Sayles,1264910
Nelson Entertainment,13000000,Duncan Gibbins,-7548881,Gregory Hines,1,Duncan Gibbins,5451119
Raffaella Productions,6000000,Avi Nesher,-5935438,Michael Biehn,5,Avi Nesher,64562
Not specified,14000000,Arthur Hiller,-12010941,Beau Bridges,3,Janet Kovalcik,1989059
Sandollar Productions,15000000,Charles Lane,-10306764,Lenny Henry,8,Andy Breckman,4693236
Live Entertainment,1200000,Quentin Tarantino,1632029,Harvey Keitel,9,Quentin Tarantino,2832029
American Zoetrope,40000000,Francis Ford Coppola,42522790,Gary Oldman,11,Bram Stoker,82522790
Walt Disney Pictures,28000000,Ron Clements,189350219,Scott Weinger,11,Ron Clements,217350219
Warner Bros.,80000000,Tim Burton,82831698,Michael Keaton,6,Bob Kane,162831698
Carolco Pictures,49000000,Paul Verhoeven,68727000,Michael Douglas,3,Joe Eszterhas,117727000
Morgan Creek Productions,40000000,Michael Mann,35505856,Daniel Day-Lewis,9,James Fenimore Cooper,75505856
Warner Bros.,14400000,Clint Eastwood,86757447,Clint Eastwood,8,David Webb Peoples,101157447
Palo Vista Productions,11000000,Jonathan Lynn,41929168,Joe Pesci,3,Dale Launer,52929168
Columbia Pictures Corporation,40000000,Rob Reiner,101340178,Tom Cruise,12,Aaron Sorkin,141340178
New Line Cinema,10000000,David Lynch,-5839149,Sheryl Lee,8,David Lynch,4160851
Twentieth Century Fox Film Corporation,50000000,David Fincher,5473600,Sigourney Weaver,5,Dan O'Bannon,55473600
Touchstone Pictures,31000000,Emile Ardolino,108610000,Whoopi Goldberg,5,Paul Rudnick,139610000
Columbia Pictures Corporation,40000000,Penny Marshall,67533928,Tom Hanks,7,Kim Wilson,107533928
Universal Pictures,55000000,Robert Zemeckis,3422650,Meryl Streep,7,Martin Donovan,58422650
Universal Pictures,31000000,Martin Brest,32895607,Al Pacino,1,Giovanni Arpino,63895607
Touchwood Pacific Partners 1,15000000,Kenny Ortega,-12180515,Christian Bale,4,Bob Tzudiker,2819485
Kasdan Pictures,25000000,Mick Jackson,96945720,Kevin Costner,11,Lawrence Kasdan,121945720
Paramount Pictures,20000000,Penelope Spheeris,101697350,Mike Myers,2,Mike Myers,121697350
Avnet/Kerner Productions,10000000,Stephen Herek,40752337,Emilio Estevez,10,Steven Brill,50752337
Dino De Laurentiis Company,11000000,Sam Raimi,502976,Bruce Campbell,2,Sam Raimi,11502976
Twentieth Century Fox Film Corporation,18000000,Chris Columbus,155585516,Macaulay Culkin,11,John Hughes,173585516
Warner Bros.,35000000,Andrew Davis,48363139,Steven Seagal,10,J.F. Lawton,83363139
GGR,12500000,James Foley,-1774772,Al Pacino,10,David Mamet,10725228
WingNut Films,3000000,Peter Jackson,-2757377,Timothy Balme,2,Stephen Sinclair,242623
PolyGram Filmed Entertainment,6000000,Bernard Rose,19792310,Virginia Madsen,10,Clive Barker,25792310
Mace Neufeld Productions,45000000,Phillip Noyce,38287363,Harrison Ford,6,Tom Clancy,83287363
Touchstone Pictures,24000000,Thom Eberhardt,-1481903,Kurt Russell,9,John Dwyer,22518097
Carolco Pictures,31000000,Richard Attenborough,-21506741,Robert Downey Jr.,1,David Robinson,9493259
Largo International N.V.,33000000,Spike Lee,15169908,Denzel Washington,11,Alex Haley,48169908
Columbia Pictures Corporation,15000000,Mick Garris,15524763,Brian Krause,4,Stephen King,30524763
FAI Films,24000000,Bill Kroyer,650296,Samantha Mathis,4,Jim Cox,24650296
Fifth Avenue Entertainment,5000000,Anthony Hickox,7534961,Terry Farrell,9,Clive Barker,12534961
Twentieth Century Fox Film Corporation,7000000,Fran Rubel Kuzui,9624456,Kristy Swanson,7,Joss Whedon,16624456
Paramount Pictures,8000000,Mary Lambert,9092453,Edward Furlong,8,Richard Outten,17092453
StudioCanal,23000000,Roland Emmerich,13299898,Jean-Claude Van Damme,7,Richard Rothstein,36299898
Encino Man Productions,7000000,Les Mayfield,33693477,Sean Astin,5,George Zaloom,40693477
Island World,5000000,Ernest R. Dickerson,15146880,Omar Epps,1,Ernest R. Dickerson,20146880
Imagine Films Entertainment,60000000,Ron Howard,-1116160,Tom Cruise,5,Bob Dolman,58883840
Warner Bros.,35000000,Richard Donner,109731527,Mel Gibson,5,Jeffrey Boam,144731527
Canal+,5000000,Roman Polanski,-3137195,Hugh Grant,3,Pascal Bruckner,1862805
Allied Vision,10000000,Brett Leonard,22101000,Jeff Fahey,3,Stephen King,32101000
New Line Cinema,3000000,Katt Shea,-1170196,Drew Barrymore,5,Melissa Goddard,1829804
Hollywood Pictures,11700000,Curtis Hanson,76336683,Annabella Sciorra,1,Amanda Silver,88036683
Columbia Pictures Corporation,16000000,Barbet Schroeder,31922919,Bridget Fonda,8,John Lutz,47922919
Bad Lt. Productions,1000000,Abel Ferrara,1000022,Harvey Keitel,12,Zoë Lund,2000022
Touchstone Pictures,6500000,Jon Turteltaub,22500301,Victor Wong,8,Kenny Kim,29000301
Universal Pictures,35000000,Phil Alden Robinson,16433000,Robert Redford,9,Phil Alden Robinson,51433000
Paramount Pictures,40000000,Reginald Hudlin,30100000,Eddie Murphy,7,Eddie Murphy,70100000
Avenue Pictures,8000000,Robert Altman,13706100,Tim Robbins,5,Michael Tolkin,21706100
Baltimore Pictures,43000000,Barry Levinson,-21547918,Robin Williams,12,Valerie Curtin,21452082
Gaumont,47000000,Ridley Scott,-39808601,Gérard Depardieu,10,Rose Bosch,7191399
Twentieth Century Fox Film Corporation,35000000,Danny DeVito,-10723500,Jack Nicholson,12,David Mamet,24276500
Warner Bros.,15000000,Kevin Hooks,29065653,Wesley Snipes,11,Stewart Raffill,44065653
Arau Films Internacional,2000000,Alfonso Arau,19665500,Marco Leonardi,5,Laura Esquivel,21665500
Columbia Pictures Corporation,7000,Robert Rodriguez,2033920,Carlos Gallardo,2,Robert Rodriguez,2040920
Olmos Productions,16000000,Edward James Olmos,-2913570,Edward James Olmos,3,Floyd Mutrux,13086430
Paramount Pictures,30000000,Ralph Bakshi,-15889400,Gabriel Byrne,7,Michael Grais,14110600
Touchwood Pacific Partners 1,40000000,Randal Kleiser,18662452,Rick Moranis,7,Stuart Gordon,58662452
Adventure Pictures,4000000,Sally Potter,1289772,Tilda Swinton,6,Sally Potter,5289772
Columbia Pictures Corporation,35000000,Richard Donner,-30348023,Lorraine Bracco,2,David Mickey Evans,4651977
Davis Entertainment,8000000,Stuart Gordon,-1260859,Christopher Lambert,9,Troy Neighbors,6739141
Cinema Plus,14000000,Greg Beeman,-11965530,Teri Garr,7,Chris Matheson,2034470
Pacific Western,12000000,Brian De Palma,9370057,John Lithgow,8,Brian De Palma,21370057
Turner Pictures (I),3500000,Phil Roman,60469,Richard Kind,7,Dennis Marks,3560469
Hollywood Pictures,40000000,John McTiernan,5500797,Sean Connery,2,Tom Schulman,45500797
Universal Pictures,30000000,George Miller,-22713612,Nick Nolte,1,George Miller,7286388
Challenge Film Corporation,7000000,Tony Maylam,-1569178,Rutger Hauer,5,Gary Scott Thompson,5430822
Hollywood Pictures,18000000,Alan J. Pakula,3591728,Kevin Kline,10,Matthew Chapman,21591728
Twentieth Century Fox Film Corporation,10000000,Dwight H. Little,4356479,Brandon Lee,8,Cindy Cirile,14356479
Touchstone Pictures,12000000,Peter Bogdanovich,-9719852,Michael Caine,3,Michael Frayn,2280148
Columbia Pictures Corporation,42000000,Stephen Frears,-22492655,Dustin Hoffman,10,Laura Ziskin,19507345
Allied Filmmakers,27000000,Roland Joffé,-12316079,Patrick Swayze,4,Dominique Lapierre,14683921
Golden Harvest Company,900000,Stanley Tong,15370600,Jackie Chan,7,Edward Tang,16270600
TriStar Pictures,15000000,Michael Apted,7660758,Val Kilmer,4,John Fusco,22660758
Castle Rock Entertainment,25000000,Andrew Bergman,10208854,James Caan,8,Andrew Bergman,35208854
Walt Disney Pictures,12000000,Brian Henson,15281507,Michael Caine,12,Charles Dickens,27281507
Corn Cobb Productions,900000,David Price,6080986,Terence Knox,1,Stephen King,6980986
Northern Lights Entertainment,45000000,Roger Spottiswoode,-16588790,Sylvester Stallone,2,Blake Snyder,28411210
British Broadcasting Corporation (BBC),5000000,Kenneth Branagh,-941436,Hugh Laurie,12,Rita Rudner,4058564
Universal Pictures,14000000,Walter Hill,-252862,Bill Paxton,12,Bob Gale,13747138
TriStar Pictures,20000000,Woody Allen,-9444381,Woody Allen,9,Woody Allen,10555619
Paramount Pictures,20000000,Bruce Robinson,-8609521,Andy Garcia,11,Bruce Robinson,11390479
Warner Bros.,40000000,John Carpenter,-25641967,Chevy Chase,2,H.F. Saint,14358033
Columbia Pictures Corporation,15000000,Peter MacDonald,25227000,Damon Wayans,7,Damon Wayans,40227000
Warner Bros.,7500000,Randall Miller,5772113,Christopher Reid,6,Michael Swerdlick,13272113
Enchantment Films Inc.,4000000,Stephen Milburn Anderson,-2626804,Byron Minns,9,Stephen Milburn Anderson,1373196
Warner Bros.,32000000,Phil Joanou,-3409335,Richard Gere,2,Robert Berger,28590665
Alcor Films,15500000,Arne Glimcher,-8757832,Armand Assante,2,Oscar Hijuelos,6742168
Morgan Creek Productions,30000000,Geoff Murphy,-12871000,Emilio Estevez,1,Robert Sheckley,17129000
Hollywood Pictures,50000000,Jonathan Lynn,-3333498,Eddie Murphy,12,Marty Kaplan,46666502
Christopher Columbus Productions,40000000,John Glen,-31748929,Marlon Brando,8,Mario Puzo,8251071
Dimension Films,10000000,Ringo Lam,-1667569,Jackie Chan,4,Barry Wong,8332431
Metro-Goldwyn-Mayer (MGM),17000000,Michael Ritchie,-12163363,James Woods,8,Leonard Wise,4836637
A&M; Films,5000000,Keith Gordon,-3473303,Peter Berg,4,William Wharton,1526697
American Zoetrope,29000000,Carroll Ballard,-23480431,Matthew Modine,9,Jeff Benjamin,5519569
Orion Pictures,18000000,Jonathan Kaplan,-16050852,Michelle Pfeiffer,2,Don Roos,1949148
DENTSU Music And Entertainment,40000000,Fred Schepisi,-19116954,Tom Selleck,10,Theo Pelletier,20883046
Penta Films,20000000,Irwin Winkler,-13797244,Robert De Niro,10,Gerald Kersh,6202756
British Screen Productions,10000000,Stephen Gyllenhaal,-8965713,Jeremy Irons,10,Graham Swift,1034287
Carolco Pictures,5000000,Paul Schrader,-3949139,Willem Dafoe,3,Paul Schrader,1050861
Castle Rock Entertainment,43000000,Billy Crystal,-29648643,Billy Crystal,9,Billy Crystal,13351357
Penta Entertainment,30000000,Bob Rafelson,-25903970,Jack Nicholson,7,Carole Eastman,4096030
Avenue Pictures,10000000,Martin Bell,-9615952,Jeff Bridges,5,Peter Silverman,384048
No Frills Film Production,2700000,Neal Jimenez,-976681,Eric Stoltz,5,Neal Jimenez,1723319
Atchafalaya,3330000,John Sayles,2084619,Mary McDonnell,12,John Sayles,5414619
Orion Pictures,18000000,Howard Deutch,-11624021,Ray Liotta,3,Ron Cutler,6375979
American Playhouse,3000000,Hal Hartley,-2858446,Robert John Burke,11,Hal Hartley,141554
Zeta Entertainment,800000,Tamra Davis,-685484,Drew Barrymore,9,Matthew Bright,114516
Paramount Pictures,18000000,Christopher Crowe,-6875489,Annabella Sciorra,8,Christopher Crowe,11124511
Ang Lee Productions,400000,Ang Lee,-247678,Bozhao Wang,1,Ang Lee,152322
Once Upon a Time Films,3000000,Matthew Meshekoff,-2309034,Arye Gross,3,Noah Stern,690966
Metro-Goldwyn-Mayer (MGM),18000000,Bruce Beresford,-15850265,Albert Finney,3,Josephine Humphreys,2149735
Desperate Pictures,22769,Gregg Araki,669816,Mike Dytri,8,Gregg Araki,692585
Majestic Films International,24000000,Graeme Clifford,-23391134,Andie MacDowell,10,Robert Dillon,608866
In The Bag Productions,13000000,Allan Moyle,-9278089,Penelope Ann Miller,8,Grace Cary Bickley,3721911
JVC Entertainment Networks,16000000,Beeban Kidron,1957265,Shirley MacLaine,1,Todd Graff,17957265
Demi-Monde Productions,130000,Nicole Conn,669674,Trisha Todd,10,Nicole Conn,799674
American Playhouse,250000,Tom Kalin,90147,Daniel Schlachet,9,Tom Kalin,340147
Island World,38000,Nick Gomez,79480,Peter Greene,8,Nick Gomez,117480
Rhythm & Hues Studios,28000000,Kenny Ortega,11514713,Bette Midler,7,David Kirschner,39514713
Hollywood Pictures,25000000,George P. Cosmatos,31505065,Kurt Russell,12,Kevin Jarre,56505065
Universal Pictures,22000000,Steven Spielberg,74067179,Liam Neeson,2,Thomas Keneally,96067179
Universal Pictures,63000000,Steven Spielberg,339453882,Sam Neill,6,Michael Crichton,402453882
Touchstone Pictures,18000000,Henry Selick,57082668,Danny Elfman,10,Tim Burton,75082668
Gramercy Pictures (I),6900000,Richard Linklater,1093039,Jason London,2,Richard Linklater,7993039
Alcor Films,25000000,Joel Schumacher,15903593,Michael Douglas,2,Ebbe Roe Smith,40903593
Davis Entertainment,42000000,Sydney Pollack,116348367,Tom Cruise,6,John Grisham,158348367
Morgan Creek Productions,13000000,Tony Scott,-718500,Christian Slater,9,Quentin Tarantino,12281500
Paramount Pictures,75000000,Barry Sonnenfeld,-26080957,Anjelica Huston,11,Charles Addams,48919043
Price Entertainment,22000000,Robert De Niro,-4733029,Robert De Niro,10,Chazz Palminteri,17266971
Paramount Pictures,11000000,Lasse Hallström,-1829786,Johnny Depp,3,Peter Hedges,9170214
Columbia Pictures Corporation,14600000,Harold Ramis,56306973,Bill Murray,2,Danny Rubin,70906973
Brooksfilms,20000000,Mel Brooks,15739755,Cary Elwes,7,J.D. Shapiro,35739755
Twentieth Century Fox Film Corporation,25000000,Chris Columbus,194200000,Robin Williams,11,Anne Fine,219200000
TriStar Pictures,21000000,Nora Ephron,105533006,Tom Hanks,6,Jeff Arch,126533006
Columbia Pictures Corporation,85000000,John McTiernan,-34983606,Arnold Schwarzenegger,6,Zak Penn,50016394
Hollywood Pictures,35000000,Taylor Hackford,-30503417,Damian Chapa,4,Ross Thomas,4496583
Carolco Pictures,70000000,Renny Harlin,14049211,Sylvester Stallone,5,John Long,84049211
Warner Bros.,44000000,Andrew Davis,139875760,Harrison Ford,8,Jeb Stuart,183875760
Warner Bros.,20000000,Simon Wincer,57698625,Jason James Richter,7,Keith Walker,77698625
Paramount Pictures,38000000,Adrian Lyne,68614100,Robert Redford,4,Jack Engelhard,106614100
TriStar Pictures,26000000,Jonathan Demme,51324422,Tom Hanks,1,Ron Nyswaner,77324422
CiBy 2000,7000000,Jane Campion,33158000,Holly Hunter,2,Jane Campion,40158000
Universal Pictures,30000000,Brian De Palma,6948322,Al Pacino,11,Edwin Torres,36948322
Touchstone Pictures,38000000,Bill Duke,19319029,Whoopi Goldberg,12,Paul Rudnick,57319029
Warner Bros.,57000000,Marco Brambilla,1055768,Sylvester Stallone,10,Peter M. Lenkov,58055768
Allied Filmmakers,42000000,Annabel Jankel,-21084535,Bob Hoskins,5,Parker Bennett,20915465
Walt Disney Pictures,30000000,Stephen Herek,23898845,Charlie Sheen,11,Alexandre Dumas,53898845
Hell's Kitchen Films,13000000,Jim Sheridan,12010410,Daniel Day-Lewis,2,Gerry Conlon,25010410
Paramount Pictures,40000000,Phillip Noyce,-3700000,Sharon Stone,5,Ira Levin,36300000
Film Andes S.A.,32000000,Frank Marshall,4733909,Ethan Hawke,1,Piers Paul Read,36733909
Columbia Pictures Corporation,30000000,Martin Scorsese,2200000,Daniel Day-Lewis,10,Edith Wharton,32200000
Twentieth Century Fox Film Corporation,17000000,Joseph Ruben,27594000,Macaulay Culkin,9,Ian McEwan,44594000
Walt Disney Pictures,15000000,Jon Turteltaub,53856263,John Candy,10,Lynn Siefert,68856263
Renaissance Films,11000000,Kenneth Branagh,11551000,Kenneth Branagh,7,William Shakespeare,22551000
Touchstone Pictures,15000000,David S. Ward,8004026,James Caan,9,David S. Ward,23004026
Raffaella De Laurentiis Productions,14000000,Rob Cohen,21112679,Jason Scott Lee,5,Robert Clouse,35112679
New Line Cinema,3500000,Albert Hughes,24400000,Tyrin Turner,5,Allen Hughes,27900000
Universal Pictures,18000000,John Woo,14589677,Jean-Claude Van Damme,8,Chuck Pfarrer,32589677
TriStar Television,25000000,Ron Maxwell,-14230040,Tom Berenger,10,Michael Shaara,10769960
Propaganda Films,8000000,John Dahl,-5497449,Nicolas Cage,5,John Dahl,2502551
TriStar Pictures,20000000,Thomas Schlamme,-8414517,Mike Myers,7,Robbie Fox,11585483
Orion Pictures,15000000,George A. Romero,-5420932,Timothy Hutton,4,Stephen King,9579068
New Line Cinema,3000000,Adam Marcus,12935068,John D. LeMay,8,Jay Huguely,15935068
Paramount Pictures,40000000,Stephen Surjik,8197805,Mike Myers,12,Mike Myers,48197805
Warner Bros.,45000000,Alan J. Pakula,55768056,Julia Roberts,12,John Grisham,100768056
Touchstone Pictures,15000000,Brian Gibson,24100956,Angela Bassett,6,Tina Turner,39100956
Columbia Pictures Corporation,40000000,Wolfgang Petersen,62314283,Clint Eastwood,7,Jeff Maguire,102314283
Morgan Creek Productions,6000000,Alan Shapiro,7609396,Cary Elwes,4,Alan Shapiro,13609396
Paramount Pictures,15000000,Robert Lieberman,5100000,D.B. Sweeney,3,Travis Walton,20100000
Trimark Pictures,900000,Mark Jones,7656940,Warwick Davis,1,Mark Jones,8556940
Warner Bros.,30000000,Clint Eastwood,1160784,Kevin Costner,11,John Lee Hancock,31160784
Columbia Pictures Corporation,15000000,James Ivory,7954968,Anthony Hopkins,11,Kazuo Ishiguro,22954968
CNCAIMC,2000000,Guillermo del Toro,-1378608,Federico Luppi,5,Guillermo del Toro,621392
Icon Entertainment International,2600000,Rob Bowman,250263,Shane McDermott,9,Bill Apablasa,2850263
Orion Pictures,22000000,Fred Dekker,-11303790,Nancy Allen,11,Edward Neumeier,10696210
PolyGram Filmed Entertainment,9000000,Dominic Sena,-6604769,Brad Pitt,9,Stephen Levy,2395231
Twentieth Century Fox Film Corporation,25000000,Jim Abrahams,13911970,Charlie Sheen,5,Jim Abrahams,38911970
Costa do Castelo Filmes,25000000,Bille August,-18734689,Jeremy Irons,4,Isabel Allende,6265311
Twentieth Century Fox Film Corporation,10000000,Daniel Stern,43579269,Thomas Ian Nicholas,7,Sam Harper,53579269
Warner Bros. Animation,6000000,Eric Radomski,-382609,Kevin Conroy,12,Bob Kane,5617391
Twentieth Century Fox Film Corporation,35000000,Philip Kaufman,28095271,Sean Connery,7,Michael Crichton,63095271
Columbia Pictures Corporation,14000000,John Singleton,13515786,Janet Jackson,7,John Singleton,27515786
Tommy,11000000,Tom Stern,-10970704,Brooke Shields,3,Tim Burns,29296
Columbia Pictures Corporation,35000000,Walter Hill,-16364380,Jason Patric,12,John Milius,18635620
Canal+,19000000,Emir Kusturica,-18893342,Johnny Depp,9,David Atkins,106658
Castle Rock Entertainment,20000000,Harold Becker,26044636,Alec Baldwin,10,Aaron Sorkin,46044636
Dino De Laurentiis Company,30000000,Uli Edel,-16724574,Madonna,1,Brad Mirman,13275426
Paramount Pictures,14000000,Peter Bogdanovich,-12970279,River Phoenix,8,Carol Heikkinen,1029721
Northern Lights Entertainment,15000000,Rod Daniel,38354166,Charles Grodin,12,John Hughes,53354166
Recorded Picture Company (RPC),35000000,Bernardo Bertolucci,-30141861,Keanu Reeves,5,Bernardo Bertolucci,4858139
Metro-Goldwyn-Mayer (MGM),12000000,Fred Schepisi,-5589324,Will Smith,12,John Guare,6410676
Alcor Films,33000000,Oliver Stone,-27135051,Hiep Thi Le,1,Le Ly Hayslip,5864949
Golden Harvest Company,17000000,Stuart Gillard,25660000,Elias Koteas,3,Kevin Eastman,42660000
New Line Cinema,8200000,Gene Quintano,19779400,Emilio Estevez,2,Don Holley,27979400
Dorset Productions,13000000,Abel Ferrara,-12571132,Gabrielle Anwar,1,Jack Finney,428868
Price Entertainment,22000000,Richard Attenborough,3842000,Anthony Hopkins,1,William Nicholson,25842000
Hollywood Pictures,11000000,Wayne Wang,21861136,Tamlyn Tomita,10,Amy Tan,32861136
Bandai Visual Company,2000000,Brian Yuzna,-1945793,Kent McCord,2,John Penney,54207
Largo Entertainment,21000000,Stephen Hopkins,-8863062,Emilio Estevez,10,Lewis Colick,12136938
Davis-Films,1500000,Roger Avary,-1081047,Eric Stoltz,9,Roger Avary,418953
Columbia Pictures Corporation,30000000,Rowdy Herrington,-6201377,Bruce Willis,9,Rowdy Herrington,23798623
Columbia Pictures Corporation,15000000,Robert Harmon,7189039,Jean-Claude Van Damme,1,Joe Eszterhas,22189039
Metro-Goldwyn-Mayer (MGM),7500000,Tony Bill,11399204,Christian Slater,2,Tom Sierchio,18899204
Universal Pictures,30000000,Barry Sonnenfeld,-19002834,Michael J. Fox,10,Mark Rosenthal,10997166
TriStar Pictures,13500000,Woody Allen,-2214412,Woody Allen,8,Woody Allen,11285588
Canal+,22000000,Richard Benjamin,22942695,Whoopi Goldberg,5,Marcia Brandwynne,44942695
Polygram Filmed Entertainment,11500000,Peter Medak,-8224415,Gary Oldman,2,Hilary Henkin,3275585
Walt Disney Pictures,6500000,Stephen Sommers,17603594,Elijah Wood,4,Mark Twain,24103594
Columbus Circle Films,15000000,Tom Holland,-8580124,Timothy Hutton,2,Kevin Falls,6419876
August Entertainment,6000000,Sheldon Lettich,-2726412,Mark Dacascos,8,Sheldon Lettich,3273588
New Line Cinema,8000000,Gus Van Sant,-6290000,Uma Thurman,5,Tom Robbins,1710000
Artimm,7000000,Robert Klane,5741891,Andrew McCarthy,7,Robert Klane,12741891
Outlaw Productions (I),9000000,Mike Binder,5904910,Alan Arkin,4,Mike Binder,14904910
Hanna-Barbera Productions,13000000,Charles Grosvenor,-6425104,Michael Crawford,6,Rae Lambert,6574896
Richard Williams Productions,28000000,Richard Williams,-27330724,Vincent Price,8,Richard Williams,669276
Metro-Goldwyn-Mayer (MGM),30000000,Robert Townsend,-21976853,Robert Townsend,8,Robert Townsend,8023147
Imagine Films Entertainment,14000000,Henry Winkler,17888805,Burt Reynolds,4,Arne Olsen,31888805
Trimark Pictures,3000000,Anthony Hickox,902679,Julian Sands,9,David Twohy,3902679
Wildwood Enterprises,8000000,Steven Soderbergh,-6700682,Jesse Bradford,8,A.E. Hotchner,1299318
New Line Cinema,10000000,Michael Gottlieb,-5752838,Hulk Hogan,10,Edward Rugoff,4247162
Film Workshop,11000000,Woo-Ping Yuen,3681661,Rongguang Yu,10,Tan Cheung,14681661
Road Movies Filmproduktion,10500000,Wim Wenders,-9689545,Otto Sander,12,Wim Wenders,810455
Castle Rock Entertainment,18000000,Billy Weber,-16471837,Jacob Tierney,11,Frank Deese,1528163
Rastar Productions,25000000,Mike Figgis,-16684025,Richard Gere,10,Eric Roth,8315975
Trimark Pictures,10000000,Christopher Coppola,-9981631,Michael Biehn,10,Christopher Coppola,18369
New Line Cinema,11000000,Michael Apted,5696219,Madeleine Stowe,1,Dana Stevens,16696219
Ang Lee Productions,1000000,Ang Lee,5933459,Winston Chao,8,Ang Lee,6933459
Beacon Communications,10000000,Leon Ichaso,8272447,Wesley Snipes,2,Barry Michael Cooper,18272447
New Line Cinema,6000000,John Lafia,6974636,Ally Sheedy,11,John Lafia,12974636
PolyGram Filmed Entertainment,10000000,Mario Van Peebles,8290000,Mario Van Peebles,5,Sy Richardson,18290000
New Horizons Picture,1000000,Adam Simon,753979,Diane Ladd,5,John Brosnan,1753979
Hollywood Pictures,14000000,Patrick Hasburgh,-5958951,Paul Gross,1,Patrick Hasburgh,8041049
Twentieth Century Fox Film Corporation,12000000,Rachel Talalay,-6913091,Karen Allen,12,William Davies,5086909
Filmauro,25000000,Blake Edwards,-22542426,Roberto Benigni,8,Maurice Richlin,2457574
Cecchi Gori Europa N.V.,10000000,Abel Ferrara,-9927505,Harvey Keitel,11,Nicholas St. John,72495
A&M; Films,12000000,Tony Bill,-10296718,Kathy Bates,11,Patrick Sheane Duncan,1703282
Krasnow Productions,19000000,Emile Ardolino,-16880006,Darci Kistler,11,Susan Cooper,2119994
Permut Presentations,11000000,Ramón Menéndez,-9955176,John Cusack,9,Mark Bowden,1044824
Miramax,8000000,Yves Simoneau,-7125852,Jamie Lee Curtis,3,Bernard Taylor,874148
DENTSU Music And Entertainment,11900000,Akira Kurosawa,-11851144,Tatsuo Matsumura,3,Akira Kurosawa,48856
Night Life Inc.,13000000,Anthony Minghella,-9874576,Matt Dillon,10,Amy Schor Ferris,3125424
StudioCanal,9000000,James B. Harris,1058318,Wesley Snipes,4,Gerald Petievich,10058318
Incorporated Television Company (ITC),999999,Rusty Cundieff,-761769,Larry B. Scott,6,Rusty Cundieff,238230
Davis Entertainment,8030000,Deran Sarafian,-4618115,Christopher Lambert,2,Stephen Sommers,3411885
Parkway Productions,13000000,John Whitesell,-10429855,Jason Priestley,9,Paul W. Shapiro,2570145
Fine Line Features,2500000,Michael Steinberg,-1735917,Phoebe Cates,4,Roger Hedden,764083
Channel Four Films,1000000,Haile Gerima,1691899,Kofi Ghanaba,5,Haile Gerima,2691899
Trimark Pictures,5000000,Stephen Cornwell,-4997030,Brad Johnson,6,Wallace C. Bennett,2970
Full Crew/Say Yea,800000,Victor Nunez,201437,Ashley Judd,11,Jane Austen,1001437
Castle Rock Entertainment,25000000,Frank Darabont,3341469,Tim Robbins,10,Stephen King,28341469
Miramax,8000000,Quentin Tarantino,99928762,John Travolta,10,Quentin Tarantino,107928762
Paramount Pictures,55000000,Robert Zemeckis,275252182,Tom Hanks,7,Winston Groom,330252182
Walt Disney Pictures,45000000,Roger Allers,267900000,Matthew Broderick,6,Irene Mecchi,312900000
Geffen Pictures,60000000,Neil Jordan,45264608,Brad Pitt,11,Anne Rice,105264608
The Mark Gordon Company,30000000,Jan de Bont,91248145,Keanu Reeves,6,Graham Yost,121248145
PolyGram Filmed Entertainment,4400000,Mike Newell,48300832,Hugh Grant,4,Richard Curtis,52700832
New Line Cinema,18000000,Chuck Russell,101938730,Jim Carrey,7,Michael Fallon,119938730
New Line Cinema,16000000,Peter Farrelly,111175354,Jim Carrey,12,Peter Farrelly,127175354
Warner Bros.,34000000,Oliver Stone,16282766,Woody Harrelson,8,Quentin Tarantino,50282766
TriStar Pictures,30000000,Edward Zwick,36638883,Brad Pitt,1,Susan Shilliday,66638883
Canal+,55000000,Roland Emmerich,16565669,Kurt Russell,10,Dean Devlin,71565669
Twentieth Century Fox Film Corporation,115000000,James Cameron,31282411,Arnold Schwarzenegger,7,Claude Zidi,146282411
Crowvision Inc.,23000000,Alex Proyas,27693162,Brandon Lee,5,James O'Barr,50693162
Morgan Creek Productions,12000000,Tom Shadyac,60217000,Jim Carrey,2,Jack Bernstein,72217000
Warner Bros.,63000000,Lawrence Kasdan,-37948000,Kevin Costner,6,Dan Gordon,25052000
Universal Pictures,46000000,Brian Levant,84512915,John Goodman,5,Tom S. Parker,130512915
Jersey Films,11500000,Ben Stiller,9482557,Winona Ryder,2,Helen Childress,20982557
Paramount Pictures,35000000,David Carson,40668868,Patrick Stewart,11,Gene Roddenberry,75668868
Touchstone Pictures,18000000,Tim Burton,-12112543,Johnny Depp,10,Rudolph Grey,5887457
New Line Cinema,8000000,Wes Craven,10090181,Heather Langenkamp,10,Wes Craven,18090181
View Askew Productions,230000,Kevin Smith,2921130,Brian O'Halloran,11,Kevin Smith,3151130
TriStar Pictures,45000000,Kenneth Branagh,-22993704,Robert De Niro,11,Mary Shelley,22006296
Mace Neufeld Productions,62000000,Phillip Noyce,60187717,Harrison Ford,8,Tom Clancy,122187717
Columbia Pictures Corporation,15000000,Gillian Armstrong,35083616,Susan Sarandon,12,Louisa May Alcott,50083616
Warner Bros.,40000000,Donald Petrie,-1912244,Macaulay Culkin,12,Neil Tolkin,38087756
Genre Pictures,600000,Kim Henkel,-458374,Renée Zellweger,10,Kim Henkel,141626
Twentieth Century Fox Film Corporation,50000000,Patrick Read Johnson,-33328495,Lara Flynn Boyle,7,John Hughes,16671505
Capcom Entertainment,35000000,Steven E. de Souza,-1576479,Jean-Claude Van Damme,12,Steven E. de Souza,33423521
Warner Bros.,20000000,Duwayne Dunham,-711179,Rick Moranis,10,James Ferguson,19288821
WingNut Films,5000000,Peter Jackson,-1950865,Melanie Lynskey,3,Fran Walsh,3049135
New Line Cinema,8000000,John Carpenter,946600,Sam Neill,2,Michael De Luca,8946600
Egg Pictures,31000000,Michael Apted,2683817,Jodie Foster,12,Mark Handley,33683817
Warner Bros.,45000000,Joel Schumacher,47115211,Susan Sarandon,7,John Grisham,92115211
Donner/Shuler-Donner Productions,75000000,Richard Donner,26631272,Mel Gibson,5,Roy Huggins,101631272
Walt Disney Pictures,22000000,John Pasquin,122833357,Tim Allen,11,Leo Benvenuti,144833357
Warner Bros.,45000000,Luis Llosa,12362581,Sylvester Stallone,10,John Shirley,57362581
Cinergi Pictures Entertainment,40000000,Penny Marshall,-15667676,Danny DeVito,6,Jim Burnstein,24332324
Vegahom Europe,27000000,Stephen Sommers,17342956,Jason Scott Lee,12,Rudyard Kipling,44342956
CiBy 2000,3000000,P.J. Hogan,12185594,Toni Collette,3,P.J. Hogan,15185594
Caravan Pictures,24000000,William Dear,26236831,Danny Glover,7,Dorothy Kingsley,50236831
Paramount Pictures,55000000,John Landis,-12390000,Eddie Murphy,5,Danilo Bach,42610000
Baltimore Pictures,31000000,Robert Redford,-6177381,Ralph Fiennes,10,Paul Attanasio,24822619
Warner Bros.,55000000,Barry Levinson,28015089,Michael Douglas,12,Michael Crichton,83015089
Columbia Pictures Corporation,70000000,Mike Nichols,-4988000,Jack Nicholson,6,Jim Harrison,65012000
Paramount Pictures,30000000,Peter Segal,21132598,Leslie Nielsen,3,Pat Proft,51132598
Twentieth Century Fox Film Corporation,27000000,Pixote Hunt,-13329312,Macaulay Culkin,11,David Kirschner,13670688
PolyGram Filmed Entertainment,30000000,Joel Coen,-27130631,Tim Robbins,3,Ethan Coen,2869369
Cinergi Pictures Entertainment,40000000,Richard Rush,-20278186,Bruce Willis,8,Billy Ray,19721814
Universal Pictures,45000000,Curtis Hanson,1815748,Meryl Streep,9,Denis O'Neill,46815748
Twentieth Century Fox Film Corporation,8000000,Hart Bochner,-3649226,Jeremy Piven,4,Adam Leff,4350774
New Line Cinema,25000000,Jeremy Leven,-2849549,Johnny Depp,4,Lord Byron,22150451
Golden Harvest Company,10000000,Chia-Liang Liu,1546543,Jackie Chan,10,Edward Tang,11546543
Universal Pictures,60000000,Ivan Reitman,-23236645,Arnold Schwarzenegger,11,Kevin Wade,36763355
Largo Entertainment,27000000,Peter Hyams,17853581,Jean-Claude Van Damme,9,Mark Verheiden,44853581
Nest Family Entertainment,20000000,Richard Rich,-10228342,Jack Palance,11,Richard Rich,9771658
New Line Cinema,3500000,Jeff Pollack,12536534,Duane Martin,3,Jeff Pollack,16036534
Etalon Film,18000000,Robert Altman,-6699347,Sophia Loren,12,Robert Altman,11300653
Incorporated Television Company (ITC),2500000,John Dahl,3638485,Linda Fiorentino,10,Steve Barancik,6138485
Seagal/Nasso Productions,50000000,Steven Seagal,-11409500,Steven Seagal,2,Ed Horowitz,38590500
Savoy Pictures,25000000,Garry Marshall,-18158430,Dana Delany,10,Anne Rice,6841570
New Line Cinema,7400000,Ernest R. Dickerson,290013,Rutger Hauer,4,Eric Bernt,7690013
Channel Four Films,2500000,Danny Boyle,381508,Kerry Fox,2,John Hodge,2881508
Universal Pictures,14000000,Spike Lee,-360000,Alfre Woodard,5,Cinqué Lee,13640000
Heathrow Productions,16000000,Tony Richardson,-12640535,Jessica Lange,9,Rama Laurie Stagner,3359465
Columbia Pictures Corporation,12000000,Christopher Cain,-3085223,Pat Morita,9,Robert Mark Kamen,8914777
Metro-Goldwyn-Mayer (MGM),50000000,Stephen Hopkins,-19844963,Jeff Bridges,7,John Rice,30155037
Don Bluth,28000000,Don Bluth,-16626499,Jodi Benson,3,Hans Christian Andersen,11373501
Universal Pictures,25000000,Russell Mulcahy,7055248,Alec Baldwin,7,Walter B. Gibson,32055248
Miramax,20000000,Woody Allen,-6616263,John Cusack,2,Woody Allen,13383737
Savoy Pictures,13000000,John Waters,-5118665,Kathleen Turner,4,John Waters,7881335
Castle Rock Entertainment,40000000,Rob Reiner,-32861551,Elijah Wood,7,Alan Zweibel,7138449
Columbia Pictures Corporation,20000000,Martin Campbell,-4660000,Ray Liotta,4,Richard Herley,15340000
Cecchi Gori Group Tiger Cinematografica,3000000,Michael Radford,18848932,Massimo Troisi,3,Antonio Skármeta,21848932
Capella International,20000000,Robert Benton,19487686,Paul Newman,1,Richard Russo,39487686
Lumière Pictures,3500000,Boaz Yakin,4594616,Sean Nelson,9,Boaz Yakin,8094616
Beacon Communications,25000000,Alan Parker,-18492486,Anthony Hopkins,10,T. Coraghessan Boyle,6507514
Touchstone Pictures,11000000,Ted Demme,439193,Denis Leary,3,Marie Weiss,11439193
Jersey Films,7000000,John G. Avildsen,12604000,Luke Perry,2,Monte Merrick,19604000
Warner Bros.,6200000,Alan Metter,-6073753,G.W. Bailey,8,Neal Israel,126247
Caravan Pictures,10000000,Keenen Ivory Wayans,19392418,Keenen Ivory Wayans,11,Keenen Ivory Wayans,29392418
Greenleaf Productions,7850000,James Yukich,-5508691,Robert Patrick,11,Paul Dini,2341309
Buckeye Films,200000,David O. Russell,1159736,Jeremy Davies,7,David O. Russell,1359736
Fine Line Features,12000000,Roman Polanski,-9896000,Sigourney Weaver,1,Ariel Dorfman,2104000
Castle Rock Entertainment,40000000,Paul Weiland,3622150,Billy Crystal,6,Lowell Ganz,43622150
Paramount Pictures,25000000,Fred Schepisi,1372663,Tim Robbins,12,Andy Breckman,26372663
Morra Brezner Steinberg and Tenenbaum Entertainment (MBST),19000000,Paul Flaherty,-11588341,Martin Short,4,William Porter,7411659
Imagine Entertainment,35000000,Gregg Champion,-14722815,Woody Harrelson,6,Robert C. Thompson,20277185
Ben-Ami/Leeds Productions,20000000,Charles T. Kanganis,-8216000,Victor Wong,5,Sang-ok Shin,11784000
TriStar Pictures,15000000,Nora Ephron,-8201760,Steve Martin,12,Nora Ephron,6798240
Cineville,700000,George Huang,-323072,Kevin Spacey,4,George Huang,376928
Paramount Pictures,45000000,John Badham,-16279620,Wesley Snipes,12,Tony Griffin,28720380
21st Century Film Corporation,5000000,Allan A. Goldstein,-3297606,Charles Bronson,1,Brian Garfield,1702394
Jackson/McHenry CompanyThe,7000000,Doug McHenry,13851521,Allen Payne,9,Bobby Smith Jr.,20851521
Paramount Pictures,45000000,Mark Rydell,-24071108,Richard Gere,1,David Rayfiel,20928892
Audifilm,4000000,Michele Soavi,-3746031,Rupert Everett,4,Gianni Romoli,253969
Hollywood Pictures,50000000,Deran Sarafian,-33521100,Charlie Sheen,9,David Twohy,16478900
Fallingcloud,26000000,Andrew Morahan,-12170266,Christopher Lambert,1,Gregory Widen,13829734
Aim,1900000,Milcho Manchevski,-1136153,Katrin Cartlidge,2,Milcho Manchevski,763847
Universal Pictures,6000000,Ron Howard,32824341,Michael Keaton,3,David Koepp,38824341
Caméra One,2800000,Nikita Mikhalkov,-183497,Nikita Mikhalkov,4,Rustam Ibragimbekov,2616503
Mulholland Productions,60000000,Glenn Gordon Caron,-41749789,Warren Beatty,10,Mildred Cram,18250211
Metro-Goldwyn-Mayer (MGM),30000000,Howard Deutch,-11561836,Macaulay Culkin,6,Tom S. Parker,18438164
Caravan Pictures,45000000,Charles Shyer,-14193806,Nick Nolte,6,Nancy Meyers,30806194
Planet Productions,2000000,Rodman Flender,260622,Warwick Davis,4,Mark Jones,2260622
Jones Entertainment Group,3000000,John Sayles,3101600,Jeni Courtney,2,Rosalie K. Fry,6101600
Fine Line Features,7000000,Alan Rudolph,-4855333,Jennifer Jason Leigh,11,Alan Rudolph,2144667
Channel Films,20000000,Hugh Wilson,7053498,Shirley MacLaine,3,Hugh Wilson,27053498
Tig Productions,15000000,John Bailey,-11961501,Ed Harris,3,Roy Carlson,3038499
Warner Bros.,30000000,Bill Forsyth,-28480634,Robin Williams,5,Bill Forsyth,1519366
Hollywood Pictures,17080000,Paul Michael Glaser,3931500,Kevin Bacon,1,Max Apple,21011500
Majestic Films International,20000000,Kevin Reynolds,-19694930,Jason Scott Lee,9,Kevin Reynolds,305070
Fine Line Features,2300000,James Gray,-1204115,Tim Roth,5,James Gray,1095885
Nelson Entertainment,13000000,Donald Petrie,-9865919,Harley Jane Kozak,4,Sara Parriott,3134081
Metro-Goldwyn-Mayer (MGM),15000000,Bob Clark,-14929064,Charles Grodin,9,Jean Shepherd,70936
American Playhouse,2300000,Hal Hartley,-1443578,Isabelle Huppert,5,Hal Hartley,856422
Kouf/Bigelow Productions,30000000,Bruce Beresford,-26819326,Richard Dreyfuss,10,Akiva Goldsman,3180674
Barcelona Films,3200000,Whit Stillman,4066973,Taylor Nichols,7,Whit Stillman,7266973
Nelson Entertainment,10500000,Floyd Mutrux,-10376491,Dermot Mulroney,9,Floyd Mutrux,123509
Baltimore Pictures,30000000,Barry Levinson,-26307126,Joe Pesci,3,Barry Levinson,3692874
Columbia Pictures Corporation,44000000,James L. Brooks,-33790889,Nick Nolte,2,James L. Brooks,10209111
Universal Pictures,15000000,Mel Smith,-13700940,Brian Benben,10,George Lucas,1299060
Acme Films Ltd.,200000,Gary Jones,786314,Gunnar Hansen,11,Tom Chaney,986314
Can I Watch,15000,Rose Troche,2393311,V.S. Brodie,7,Rose Troche,2408311
Orion Pictures,10700000,Bill Fishman,-9461920,David Johansen,1,Nat Hiken,1238080
Kino Link Company,1000000,Michael Almereyda,-553066,Elina Löwensohn,9,Michael Almereyda,446934
Walt Disney Pictures,19200000,Xavier Koller,-15862315,Adam Beach,10,Darlene Craviotto,3337685
Metro-Goldwyn-Mayer (MGM),18000000,Mick Jackson,-10496808,Dana Carvey,5,Robert King,7503192
Capitol Films,20000000,Bruce Beresford,-17691610,Colin Friels,9,William Boyd,2308390
Cecchi Gori Pictures,33000000,David Fincher,67125643,Morgan Freeman,9,Andrew Kevin Walker,100125643
TriStar Pictures,50000000,Joe Johnston,50475249,Robin Williams,12,Jonathan Hensleigh,100475249
Icon Entertainment International,72000000,Mel Gibson,3600000,Mel Gibson,5,Randall Wallace,75600000
PolyGram Filmed Entertainment,6000000,Bryan Singer,17341568,Kevin Spacey,9,Christopher McQuarrie,23341568
Warner Bros.,60000000,Michael Mann,7436818,Al Pacino,12,Michael Mann,67436818
Paramount Pictures,12000000,Amy Heckerling,44631572,Alicia Silverstone,7,Amy Heckerling,56631572
Walt Disney Pictures,55000000,Mike Gabriel,86600000,Mel Gibson,6,Carl Binder,141600000
Universal Pictures,29000001,Terry Gilliam,28141458,Bruce Willis,1,Chris Marker,57141459
Pixar Animation Studios,30000000,John Lasseter,161796233,Tom Hanks,11,John Lasseter,191796233
Warner Bros.,100000000,Joel Schumacher,84031112,Val Kilmer,6,Bob Kane,184031112
Eon Productions,60000000,Martin Campbell,46600000,Pierce Brosnan,11,Ian Fleming,106600000
Universal Pictures,52000000,Martin Scorsese,-9561700,Robert De Niro,11,Nicholas Pileggi,42438300
Guys Upstairs,1500000,Larry Clark,5917210,Leo Fitzpatrick,9,Harmony Korine,7417210
Carolco Pictures,45000000,Paul Verhoeven,-24697039,Elizabeth Berkley,9,Joe Eszterhas,20302961
Universal Pictures,50000000,Brad Silberling,50328194,Bill Pullman,5,Joseph Oriolo,100328194
New Line Cinema,3500000,F. Gary Gray,23967564,Ice Cube,4,Ice Cube,27467564
Castle Rock Entertainment,2500000,Richard Linklater,3035405,Ethan Hawke,1,Richard Linklater,5535405
New Line Cinema,18000000,Paul W.S. Anderson,52454098,Christopher Lambert,8,Ed Boon,70454098
Universal Pictures,52000000,Ron Howard,121837933,Tom Hanks,6,Jim Lovell,173837933
United Artists,20000000,Iain Softley,-12436000,Jonny Lee Miller,9,Rafael Moreu,7564000
Don Simpson/Jerry Bruckheimer Films,19000000,Michael Bay,46807024,Will Smith,4,George Gallo,65807024
Cinergi Pictures Entertainment,90000000,John McTiernan,10012499,Bruce Willis,5,Jonathan Hensleigh,100012499
Universal Pictures,10000000,Tamra Davis,15588750,Adam Sandler,2,Tim Herlihy,25588750
Universal Pictures,175000000,Kevin Reynolds,-86753780,Kevin Costner,7,Peter Rader,88246220
Paramount Pictures,50000000,Frank Marshall,31022101,Laura Linney,6,Michael Crichton,81022101
Columbia Pictures Corporation,16000000,Ang Lee,27182776,Emma Thompson,1,Jane Austen,43182776
Metro-Goldwyn-Mayer (MGM),30250000,Barry Sonnenfeld,41827000,Gene Hackman,10,Elmore Leonard,72077000
Universal Pictures,62000000,Rob Reiner,3000000,Michael Douglas,11,Aaron Sorkin,65000000
Trilogy Entertainment Group,25000000,Rachel Talalay,-20935667,Lori Petty,3,Alan Martin,4064333
Caravan Pictures,9500000,Victor Salva,21362146,Mary Steenburgen,10,Victor Salva,30862146
Metro-Goldwyn-Mayer (MGM),35000000,Roger Donaldson,25074103,Natasha Henstridge,7,Dennis Feldman,60074103
Club d'Investissement Média,18000000,Marc Caro,-16486972,Ron Perlman,12,Gilles Adrien,1513028
Lumiere Pictures,3600000,Mike Figgis,28368347,Nicolas Cage,2,John O'Brien,31968347
Columbia Pictures Corporation,7000000,Robert Rodriguez,18625110,Antonio Banderas,8,Robert Rodriguez,25625110
Universal Pictures,30000000,Chris Noonan,36600000,James Cromwell,8,Dick King-Smith,66600000
Lightstorm Entertainment,42000000,Kathryn Bigelow,-34081000,Ralph Fiennes,10,James Cameron,7919000
Morgan Creek Productions,30000000,Steve Oedekerk,78385533,Jim Carrey,11,Jack Bernstein,108385533
Miramax,4000000,Allison Anders,301331,Tim Roth,12,Allison Anders,4301331
Hollywood Pictures,17000000,Jon Turteltaub,64057016,Sandra Bullock,4,Daniel G. Sullivan,81057016
TriStar Pictures,32000000,Sam Raimi,-13363463,Sharon Stone,2,Simon Moore,18636537
Hollywood Pictures,70000000,Danny Cannon,-35306519,Sylvester Stallone,6,John Wagner,34693481
Universal Pictures,22000000,John Carpenter,-12582433,Christopher Reeve,4,John Wyndham,9417567
Warner Bros.,17000000,Alfonso Cuarón,-6980693,Liesel Matthews,5,Frances Hodgson Burnett,10019307
Paramount Pictures,12000000,Betty Thomas,34576136,Shelley Long,2,Sherwood Schwartz,46576136
Havoc,11000000,Tim Robbins,28387284,Susan Sarandon,2,Helen Prejean,39387284
Lancaster Gate,25000000,Howard Deutch,44870000,Walter Matthau,12,Mark Steven Johnson,69870000
Regency Enterprises,20000000,Jon Amiel,12051917,Sigourney Weaver,10,Ann Biderman,32051917
Twentieth Century Fox Film Corporation,15000000,Bryan Spicer,22804616,Karan Ashley,6,John Kamps,37804616
Warner Bros.,50000000,Wolfgang Petersen,17823573,Dustin Hoffman,3,Laurence Dworet,67823573
Pandora Filmproduktion,9000000,Jim Jarmusch,-7962153,Johnny Depp,5,Jim Jarmusch,1037847
Hollywood Pictures,53000000,Tony Scott,38400000,Gene Hackman,5,Michael Schiffer,91400000
Warner Bros.,24000000,Clint Eastwood,47516617,Clint Eastwood,6,Richard LaGravenese,71516617
Hollywood Pictures,23000000,John N. Smith,61919401,Michelle Pfeiffer,8,LouAnne Johnson,84919401
Columbia Pictures Corporation,20000000,Gus Van Sant,1284514,Nicole Kidman,10,Joyce Maynard,21284514
Gramercy Pictures (I),6000000,Kevin Smith,-3877439,Shannen Doherty,10,Kevin Smith,2122561
Halloween VI Productions,5000000,Joe Chappelle,10116634,Donald Pleasence,9,Debra Hill,15116634
Warner Bros.,60000000,Geoff Murphy,-9975917,Steven Seagal,7,Richard Hatem,50024083
TriStar Pictures,25000000,Robert Longo,-5924000,Keanu Reeves,5,William Gibson,19076000
Twentieth Century Fox Film Corporation,20000000,Alfonso Arau,30012507,Keanu Reeves,8,Robert Mark Kamen,50012507
Sweetland Films,15000000,Woody Allen,-8300000,Woody Allen,11,Woody Allen,6700000
Warner Bros.,50000000,Richard Donner,-19693732,Sylvester Stallone,10,Lilly Wachowski,30306268
Constellation Entertainment,58000000,Sydney Pollack,-4327920,Harrison Ford,12,Samuel A. Taylor,53672080
United Artists,28000000,Michael Caton-Jones,3600000,Liam Neeson,4,Alan Sharp,31600000
Columbia Pictures Corporation,55000000,Jerry Zucker,-17399565,Sean Connery,7,Lorne Cameron,37600435
Gaumont,30000000,Mel Brooks,-19306351,Leslie Nielsen,12,Mel Brooks,10693649
Beckner/Gorman Productions,98000000,Renny Harlin,-87982678,Geena Davis,12,Michael Frost Beckner,10017322
Tales From The Crypt Holdings,13000000,Ernest R. Dickerson,8088568,Billy Zane,1,Ethan Reiff,21088568
Columbia Pictures Corporation,22000000,Irwin Winkler,28727965,Sandra Bullock,7,John Brancato,50727965
Caravan Pictures,10000000,Albert Hughes,14200000,Larenz Tate,10,Allen Hughes,24200000
Columbia Pictures Corporation,45000000,Frank Oz,-9382401,Hal Scardino,7,Lynne Reid Banks,35617599
Hollywood Pictures,23000000,Stephen Herek,59569971,Richard Dreyfuss,1,Patrick Sheane Duncan,82569971
Allied Stars Ltd.,50000000,Roland Joffé,-39600000,Demi Moore,10,Nathaniel Hawthorne,10400000
Eddie Murphy Productions,20000000,Wes Craven,-248264,Eddie Murphy,10,Eddie Murphy,19751736
Tapestry Films,15000000,Michael Gottlieb,-1593283,Thomas Ian Nicholas,8,Michael Part,13406717
First Look International,8000000,Gregory Widen,8115878,Christopher Walken,9,Gregory Widen,16115878
Sandollar Productions,30000000,Charles Shyer,46594000,Steve Martin,12,Albert Hackett,76594000
Suburban Pictures,800000,Todd Solondz,3971000,Heather Matarazzo,5,Todd Solondz,4771000
United Artists,30000000,Walter Hill,-27832192,Jeff Bridges,12,Peter Dexter,2167808
Triumph Films,20000000,Christian Duguay,-14218115,Peter Weller,1,Philip K. Dick,5781885
Beacon Communications,6500000,Melanie Mayron,3185976,Schuyler Fisk,8,Ann M. Martin,9685976
FIT Productions,8000000,Agnieszka Holland,-7660111,Leonardo DiCaprio,11,Christopher Hampton,339889
Paramount Pictures,30000000,Brett Leonard,-5952000,Denzel Washington,8,Eric Bernt,24048000
Cinergi Pictures Entertainment,50000000,Oliver Stone,-36439040,Anthony Hopkins,1,Stephen J. Rivele,13560960
Paramount Pictures,50000000,William Friedkin,-40204983,David Caruso,10,Joe Eszterhas,9795017
Caravan Pictures,12000000,Holly Goldberg Sloan,5725500,Steve Guttenberg,9,Holly Goldberg Sloan,17725500
Seraphim Films,12000000,Clive Barker,1293081,Scott Bakula,8,Clive Barker,13293081
Golden Harvest Company,7500000,Stanley Tong,24892047,Jackie Chan,2,Edward Tang,32392047
American Playhouse Theatrical Films,1000000,Todd Haynes,-487755,Julianne Moore,6,Todd Haynes,512245
Universal Pictures,10000000,Jocelyn Moorhouse,13574130,Winona Ryder,10,Whitney Otto,23574130
Castle Rock Entertainment,11000000,Oliver Parker,-8887049,Laurence Fishburne,1,Oliver Parker,2112951
Twentieth Century Fox Film Corporation,16000000,Forest Whitaker,51052156,Whitney Houston,12,Terry McMillan,67052156
Universal Pictures,35000000,Peter Hyams,-14649829,Jean-Claude Van Damme,12,Karen Elise Baldwin,20350171
Universal Pictures,25000000,Spike Lee,-11959397,Harvey Keitel,9,Richard Price,13040603
Miramax,7000000,Gary Fleder,-6470234,Andy Garcia,12,Scott Rosenberg,529766
Dog Eat Dog Films,11000000,Michael Moore,-10821896,John Candy,9,Michael Moore,178104
American Playhouse,5500000,Gregory Nava,5579373,Jimmy Smits,5,Gregory Nava,11079373
JDI Productions,500000,Tom DiCillo,648752,Steve Buscemi,7,Tom DiCillo,1148752
Miramax,7000000,Wayne Wang,1349430,Harvey Keitel,6,Paul Auster,8349430
TriStar Pictures,27000000,Carl Franklin,-10969904,Denzel Washington,9,Walter Mosley,16030096
Miramax,9000000,Sean Penn,-8167090,Jack Nicholson,11,Sean Penn,832910
Columbia Pictures,68000000,Joseph Ruben,-32675768,Wesley Snipes,11,Doug Richardson,35324232
Paramount Pictures,33000000,John Badham,-24830637,Johnny Depp,11,Patrick Sheane Duncan,8169363
Paramount Pictures,20000000,Jodie Foster,-2481780,Holly Hunter,11,Chris Radant,17518220
Twentieth Century Fox Film Corporation,40000000,Barbet Schroeder,-25057578,David Caruso,4,Eleazar Lipsky,14942422
40 Acres & A Mule Filmworks,6000000,Rusty Cundieff,5797927,Clarence Williams III,5,Rusty Cundieff,11797927
Paramount Pictures,17000000,Stephen Gyllenhaal,-9396234,Jessica Lange,3,Seth Margolis,7603766
Alcor Films,21000000,Herbert Ross,2450000,Whoopi Goldberg,2,Don Roos,23450000
Caravan Pictures,32000000,Jeremiah S. Chechik,-23752373,Patrick Swayze,3,Steve Bloom,8247627
Savoy Pictures,15000000,Preston A. Whitmore II,-8985660,Allen Payne,2,Preston A. Whitmore II,6014340
Brothers McMullen Productions,25000,Edward Burns,10221600,Jack Mulcahy,8,Edward Burns,10246600
Warner Bros.,50000000,Andrew Sipes,-38465523,William Baldwin,11,Paula Gosling,11534477
Fine Line Features,250000,Maria Maggenti,1727544,Laurel Holloman,6,Maria Maggenti,1977544
A Band Apart,7000000,Desmond Nakano,-3239485,John Travolta,12,Desmond Nakano,3760515
Metro-Goldwyn-Mayer (MGM),15000000,Carlo Carlei,-11012351,Matthew Modine,6,James Herbert,3987649
Avenue Pictures,19000000,Michael Hoffman,-14900000,Robert Downey Jr.,2,Rose Tremain,4100000
Miramax,2000000,Paul Auster,-724001,Harvey Keitel,10,Paul Auster,1275999
Universal Pictures,10000000,J.F. Lawton,-3392348,Christopher Lambert,2,J.F. Lawton,6607652
Hollywood Pictures,10500000,Randall Miller,15825256,Sinbad,1,Michael J. Di Gaetano,26325256
TriStar Pictures,15000000,Brett Leonard,-2798745,Jeff Goldblum,3,Dean R. Koontz,12201255
Metro-Goldwyn-Mayer (MGM),28000000,Don Bluth,-24016088,Martin Short,4,Rachel Koretsky,3983912
TriStar Pictures,6400000,Peter Hall,449998,Rebecca De Mornay,10,Lewis A. Green,6849998
Rank Organisation The,8000000,David Price,-5236980,Sean Young,8,David Price,2763020
Touchstone Pictures,14000000,James Ivory,-11526000,Nick Nolte,3,Ruth Prawer Jhabvala,2474000
40 Acres & A Mule Filmworks,5000000,Nick Gomez,-1434492,Shar-Ron Corley,4,Nick Gomez,3565508
British Broadcasting Corporation (BBC),4000000,Mike Newell,-3741805,Hugh Grant,7,Beryl Bainbridge,258195
Party Productions,150000,Daisy von Scherler Mayer,322370,Parker Posey,6,Harry Birckmayer,472370
Castle Rock Entertainment,23000000,John Boorman,-17249890,Patricia Arquette,8,Alex Lasker,5750110
Republic Pictures (II),3000000,Mark Jones,-2705009,Max Grodénchik,11,Mark Jones,294991
Populist Pictures,6500000,Steven Soderbergh,-5963977,Peter Gallagher,4,Don Tracy,536023
Samuel Goldwyn Company The,11000000,Mira Nair,-8167174,Marisa Tomei,5,Christine Bell,2832826
Live Entertainment,6000000,Aaron Norris,-906293,Chuck Norris,4,Aaron Norris,5093707
Avrora Media,2000000,Anthony Waller,-795570,Marina Zudina,9,Anthony Waller,1204430
Charles Matthau-Jerry Tokofsky-John Davis Productions,8000000,Charles Matthau,-7506993,Piper Laurie,10,Truman Capote,493007
Hollywood Pictures,22000000,Peter Yates,-9900000,Peter Falk,3,Max Apple,12100000
Ferdos Films,150000,Jafar Panahi,324047,Aida Mohammadkhani,11,Abbas Kiarostami,474047
Michael Ritchie Productions,10000000,Michael Ritchie,-9955243,Joel Grey,6,Tom Jones,44757
Warner Bros.,92000000,Jan de Bont,149721524,Helen Hunt,5,Michael Crichton,241721524
Channel Four Films,3500000,Danny Boyle,13001785,Ewan McGregor,8,John Hodge,16501785
PolyGram Filmed Entertainment,7000000,Joel Coen,17611975,William H. Macy,4,Ethan Coen,24611975
Dimension Films,14000000,Wes Craven,89046663,Neve Campbell,12,Kevin Williamson,103046663
Dimension Films,19000000,Robert Rodriguez,6753840,Harvey Keitel,1,Robert Kurtzman,25753840
Twentieth Century Fox Film Corporation,75000000,Roland Emmerich,231169255,Will Smith,7,Dean Devlin,306169255
Bazmark Films,14500000,Baz Luhrmann,31851345,Leonardo DiCaprio,11,William Shakespeare,46351345
TriStar Pictures,36000000,Danny DeVito,-2915751,Danny DeVito,8,Roald Dahl,33084249
Universal Pictures,12000000,Dennis Dugan,26624000,Adam Sandler,2,Tim Herlihy,38624000
NDF International,3000000,Mira Nair,1109095,Naveen Andrews,2,Helena Kriel,4109095
Astoria Films,44000000,Barry Levinson,5100000,Robert De Niro,10,Lorenzo Carcaterra,49100000
Miramax,27000000,Anthony Minghella,51651430,Ralph Fiennes,12,Michael Ondaatje,78651430
TriStar Pictures,50000000,Cameron Crowe,103952592,Tom Cruise,12,Cameron Crowe,153952592
Columbia Pictures Corporation,15000000,Andrew Fleming,9881000,Robin Tunney,5,Peter Filardi,24881000
Paramount Pictures,80000000,Brian De Palma,100981856,Tom Cruise,5,Bruce Geller,180981856
Paramount Pictures,30000000,Gregory Hoblit,26116183,Richard Gere,4,William Diehl,56116183
Warner Bros. Family Entertainment,80000000,Joe Pytka,10463534,Michael Jordan,11,Leo Benvenuti,90463534
Hollywood Pictures,75000000,Michael Bay,59069511,Sean Connery,6,David Weisberg,134069511
Regency Enterprises,40000000,Joel Schumacher,68766007,Matthew McConaughey,7,John Grisham,108766007
Tim Burton Productions,70000000,Tim Burton,-32228983,Jack Nicholson,12,Len Brown,37771017
Dimension Films,4000000,Kevin Yagher,12675000,Bruce Ramsay,3,Peter Atkins,16675000
Columbia Pictures Corporation,36000000,Milos Forman,-15808688,Woody Harrelson,1,Scott Alexander,20191312
United Artists,31000000,Mike Nichols,93060553,Robin Williams,3,Jean Poiret,124060553
New Line Cinema,40000000,John Frankenheimer,-12336018,David Thewlis,8,H.G. Wells,27663982
Walt Disney Feature Animation,100000000,Gary Trousdale,138851,Demi Moore,6,Tab Murphy,100138851
Twentieth Century Fox Film Corporation,25000000,Nicholas Hytner,-17659897,Daniel Day-Lewis,11,Arthur Miller,7340103
Clavius Base,26000000,Tom Hanks,-190187,Tom Hanks,10,Tom Hanks,25809813
Miramax,890000,Billy Bob Thornton,23585416,Billy Bob Thornton,3,Billy Bob Thornton,24475416
Digital Image Associates,45000000,Jonathan Frakes,47001027,Patrick Stewart,11,Gene Roddenberry,92001027
Alliance Communications Corporation,9000000,David Cronenberg,-6961550,James Spader,3,J.G. Ballard,2038450
Warner Bros.,55000000,Stuart Baird,1569216,Kurt Russell,3,Jim Thomas,56569216
Regency Enterprises,45000000,Ron Shelton,8854588,Kevin Costner,8,John Norville,53854588
Columbia Pictures Corporation,7000000,Wes Anderson,-6439931,Luke Wilson,2,Owen Wilson,560069
Motion Picture Corporation of America (MPCA),15000000,Jason Bloom,11757000,Pauly Shore,1,Adam Leff,26757000
Walt Disney Pictures,75000000,Stephen Herek,61189294,Glenn Close,11,Dodie Smith,136189294
Island Pictures,3800000,Paris Barclay,16309115,Shawn Wayans,1,Shawn Wayans,20109115
Rysher Entertainment,27000000,Bobby Farrelly,-2055787,Woody Harrelson,7,Barry Fanaro,24944213
Walt Disney Pictures,38000000,Henry Selick,-9065242,Paul Terry,4,Roald Dahl,28934758
Dino De Laurentiis Company,4500000,Lana Wachowski,-701468,Jennifer Tilly,10,Lilly Wachowski,3798532
Castle Rock Entertainment,40000000,Andrew Bergman,-6890257,Demi Moore,6,Carl Hiaasen,33109743
Paramount Pictures,26000000,Hugh Wilson,79489203,Goldie Hawn,9,Olivia Goldsmith,105489203
Paramount Pictures,8500000,Tom Holland,6671475,Joe Mantegna,10,Stephen King,15171475
Universal Pictures,57000000,Rob Cohen,-5632625,Dennis Quaid,5,Patrick Read Johnson,51367375
Imagine Entertainment,54000000,Tom Shadyac,74814019,Eddie Murphy,6,Jerry Lewis,128814019
Doug Liman Productions,200000,Doug Liman,4305922,Vince Vaughn,4,Jon Favreau,4505922
Columbia Pictures Corporation,47000000,Ben Stiller,13240295,Jim Carrey,6,Lou Holtz Jr.,60240295
Castle Rock Entertainment,18000000,Kenneth Branagh,-13585465,Kenneth Branagh,12,William Shakespeare,4414535
Universal Pictures,30000000,Peter Jackson,-13240784,Michael J. Fox,7,Fran Walsh,16759216
Fiction Films,10000000,Bernardo Bertolucci,-5426670,Jeremy Irons,6,Bernardo Bertolucci,4573330
Miramax,6000000,Douglas McGrath,16201883,Gwyneth Paltrow,8,Jane Austen,22201883
Paramount Pictures,50000000,John Carpenter,-24522635,Kurt Russell,8,John Carpenter,25477365
Forge,65000000,Renny Harlin,-31671949,Geena Davis,10,Shane Black,33328051
American Zoetrope,45000000,Francis Ford Coppola,13620973,Robin Williams,8,James DeMonaco,58620973
Kopelson Entertainment,100000000,Chuck Russell,1295562,Arnold Schwarzenegger,6,Tony Puryear,101295562
Twentieth Century Fox Film Corporation,50000000,John Woo,20770147,John Travolta,2,Graham Yost,70770147
Columbia Pictures Corporation,45000000,Harold Ramis,-24900000,Michael Keaton,7,Chris Miller,20100000
New Line Cinema,9000000,F. Gary Gray,27049108,Jada Pinkett Smith,11,Takashi Bufford,36049108
Live Entertainment,25000000,David Twohy,-10951628,Charlie Sheen,5,David Twohy,14048372
Constellation Entertainment,55000000,Stephen Hopkins,-16380595,Michael Douglas,10,William Goldman,38619405
Rysher Entertainment,4100000,Campbell Scott,7781039,Tony Shalhoub,9,Stanley Tucci,11881039
1492 Pictures,60000000,Brian Levant,573641,Arnold Schwarzenegger,11,Randy Kornfield,60573641
Twentieth Century Fox Film Corporation,31000000,David S. Ward,-5214397,Kelsey Grammer,3,Hugh Wilson,25785603
Touchstone Pictures,80000000,Ron Howard,56492681,Mel Gibson,11,Cyril Hume,136492681
Hollywood Pictures,55000000,Alan Parker,-4952821,Madonna,1,Tim Rice,50047179
Lone Wolf,67000000,Walter Hill,-49400000,Bruce Willis,9,Ryûzô Kikushima,17600000
Touchstone Pictures,32000000,Jon Turteltaub,72636382,John Travolta,7,Gerald Di Pego,104636382
Scott Rudin Productions,23000000,Jerry Zaks,-10217492,Meryl Streep,2,Scott McPherson,12782508
Davis Entertainment,46000000,Edward Zwick,13031057,Denzel Washington,7,Patrick Sheane Duncan,59031057
Miramax,20000000,Woody Allen,-10285518,Woody Allen,1,Woody Allen,9714482
Green Parrot,3000000,Paul Thomas Anderson,-2777441,Philip Baker Hall,2,Paul Thomas Anderson,222559
Australian Film Finance Corporation (AFFC),5500000,Scott Hicks,30311509,Geoffrey Rush,2,Jan Sardi,35811509
Davis Entertainment,80000000,Rob Cohen,-46976531,Sylvester Stallone,12,Leslie Bohem,33023469
Paramount Pictures,45000000,Simon Wincer,-27699111,Billy Zane,6,Lee Falk,17300889
Eleventh Street Production,3300000,Julian Schnabel,-338009,Jeffrey Wright,8,Lech Majewski,2961991
Good Machine,3500000,Edward Burns,5949219,Edward Burns,8,Edward Burns,9449219
Kushner-Locke Company The,3000000,Matthew Bright,-2704507,Reese Witherspoon,12,Matthew Bright,295493
Hollywood Pictures,18000000,Rick Friedberg,8906039,Leslie Nielsen,5,Jason Friedberg,26906039
Amblin Entertainment,8000000,David Koepp,-4405152,Kyle MacLachlan,8,James Burke,3594848
MDP Worldwide,30000000,Jean-Claude Van Damme,-8400000,Jean-Claude Van Damme,4,Frank Dux,21600000
TriStar Pictures,55000000,Tony Scott,-36426209,Robert De Niro,8,Peter Abrahams,18573791
Universal City Studios,13000000,Gilbert Adler,-7412145,Dennis Miller,8,William M. Gaines,5587855
Castle Rock Entertainment,4000000,Christopher Guest,-1076018,Christopher Guest,1,Christopher Guest,2923982
Warner Bros.,28000000,Neil Jordan,-16907441,Liam Neeson,10,Neil Jordan,11092559
Hollywood Pictures,38000000,Ridley Scott,-27700000,Jeff Bridges,2,Charles Gieg Jr.,10300000
Channel Four Films,4500000,Mike Leigh,8917292,Timothy Spall,2,Mike Leigh,13417292
Columbia Pictures Corporation,5000000,John Sayles,8269963,Chris Cooper,6,John Sayles,13269963
Interscope Communications,20000000,Paul Michael Glaser,-1123419,Shaquille O'Neal,7,Paul Michael Glaser,18876581
Paramount Pictures,20000000,John Schlesinger,6792700,Sally Field,1,Erika Holzer,26792700
Bad Bird Productions,13000000,Tim Pope,4883659,Vincent Perez,8,James O'Barr,17883659
Universal Pictures,25000000,Ernest R. Dickerson,-3837580,Damon Wayans,9,Joe Gayton,21162420
Castle Rock Entertainment,36000000,Rob Reiner,-22947259,Alec Baldwin,1,Lewis Colick,13052741
Chicago Pacific Entertainment,50000000,Andrew Davis,-29449288,Keanu Reeves,8,Arne Schmidt,20550712
Largo Entertainment,29000000,Lee Tamahori,-17500000,Nick Nolte,4,Peter Dexter,11500000
Warner Bros.,45000000,John Gray,-24900000,Steven Seagal,10,Kevin Brodbin,20100000
TriStar Pictures,42000000,Barbra Streisand,-747572,Barbra Streisand,11,André Cayatte,41252428
Ladd Company The,15000000,Arlene Sanford,6397954,Shelley Long,8,Sherwood Schwartz,21397954
Touchstone Pictures,60000000,Jon Avnet,-8911295,Robert Redford,3,Joan Didion,51088705
Universal Pictures,25530000,Alan Shapiro,-5482285,Paul Hogan,5,Ricou Browning,20047715
Mundy Lane Entertainment,40000000,Penny Marshall,8102795,Denzel Washington,12,Robert Nathan,48102795
Paramount Pictures,12000000,Mike Judge,51071133,Mike Judge,12,Mike Judge,63071133
Geffen Pictures,13000000,John Payson,-8388376,Jerry O'Connell,7,John Payson,4611624
Morgan Creek Productions,7000000,Eric Red,-5944475,Mariel Hemingway,11,Wayne Smith,1055525
Nickelodeon Movies,13000000,Bronwen Hughes,13539321,Michelle Trachtenberg,7,Louise Fitzhugh,26539321
Jackson/McHenry CompanyThe,8000000,Martin Lawrence,26746109,Martin Lawrence,4,Martin Lawrence,34746109
Miramax,7000000,David O. Russell,7891000,Ben Stiller,4,David O. Russell,14891000
Columbia Pictures Corporation,44000000,Brian Gibson,-21245275,Demi Moore,2,George Dawes Green,22754725
Imagine Entertainment,39000000,Jonathan Lynn,-8643207,Steve Martin,3,Nat Hiken,30356793
Columbia Pictures Corporation,25000000,Ringo Lam,-10497517,Jean-Claude Van Damme,9,Larry Ferguson,14502483
United Artists Pictures,30000000,Howard Franklin,-21710028,Bill Murray,11,Roy Blount Jr.,8289972
Peters Entertainment,21500000,Peter Segal,794341,Jack Lemmon,12,E. Jack Kaplan,22294341
New Line Cinema,25000000,Steve Barron,-9905470,Martin Landau,7,Sherry Mills,15094530
British Broadcasting Corporation (BBC),7000000,Michael Winterbottom,-6594856,Christopher Eccleston,10,Hossein Amini,405144
NFH Productions,47000000,Stephen Frears,-41400000,Julia Roberts,2,Valerie Martin,5600000
Miramax,8000000,Matt Reeves,-2387414,David Schwimmer,5,Jason Katims,5612586
Castle Rock Entertainment,38000000,Michael Apted,-20694789,Hugh Grant,9,Michael Palmer,17305211
Addis Wechsler Pictures,1300000,Steve Buscemi,-604771,Steve Buscemi,10,Steve Buscemi,695229
Independent Pictures (II),3000000,Alexander Payne,-2846845,Laura Dern,12,Alexander Payne,153155
Caravan Pictures,35000000,Barbet Schroeder,-26202161,Meryl Streep,2,Rosellen Brown,8797839
Longview Entertainment,24000000,Bill Couturié,-17712000,Matt LeBlanc,3,Ken Richards,6288000
Dino De Laurentiis Company,18000000,John Dahl,-15219722,Ray Liotta,2,Bill Geddie,2780278
Universal Pictures,50000000,James Foley,-35448641,Chris O'Donnell,10,John Grisham,14551359
New Line Cinema,15000000,Farhad Mann,-12590775,Patrick Bergin,1,Farhad Mann,2409225
Castle Rock Entertainment,40000000,Harold Becker,-19800000,Al Pacino,2,Ken Lipper,20200000
Castle Rock Entertainment,23000000,Fraser C. Heston,-11432977,Thora Birch,8,Andy Burg,11567023
Renaissance Films,5000000,Trevor Nunn,-4448455,Helena Bonham Carter,10,William Shakespeare,551545
Metro-Goldwyn-Mayer (MGM),25000000,Kevin Hooks,-7900000,Laurence Fishburne,7,Preston A. Whitmore II,17100000
October Films,12500000,Abel Ferrara,-11272676,Christopher Walken,11,Nicholas St. John,1227324
Fox Searchlight Pictures,12000000,Spike Lee,-7097000,Theresa Randle,3,Suzan-Lori Parks,4903000
A Band Apart,2309723,Reb Braddock,-2260103,William Baldwin,9,Reb Braddock,49620
Recorded Picture Company (RPC),22000000,Bob Rafelson,-20924712,Jack Nicholson,2,Nick Villiers,1075288
PVM Entertainment,25000000,Phil Joanou,-19995000,Alec Baldwin,5,James Lee Burke,5005000
Permut Presentations,30000000,Steve Rash,1356117,Whoopi Goldberg,5,Steve Zacharias,31356117
Bruin Grip Services,8000000,Larry Bishop,-7919974,Ellen Barkin,11,Larry Bishop,80026
Imagine Entertainment,25000000,John Landis,-22584407,Tom Arnold,8,James Marshall,2415593
TriStar Pictures,25000000,Richard Benjamin,-14930000,Shirley MacLaine,4,Cornell Woolrich,10070000
Albino Alligator Productions,5000000,Kevin Spacey,-4673692,Matt Dillon,1,Christian Forte,326308
Pope Productions,500000,Lisa Krueger,2313,Scarlett Johansson,7,Lisa Krueger,502313
Regency Enterprises,17000000,Arthur Hiller,-13691242,Tom Arnold,8,Don Rhymer,3308758
Fine Line Features,6000000,Keith Gordon,-5607638,Nick Nolte,11,Kurt Vonnegut Jr.,392362
Merchant Ivory Productions,16000000,James Ivory,-13998000,Anthony Hopkins,9,Arianna Huffington,2002000
Fernando Trueba Producciones Cinematográficas,24000000,Fernando Trueba,-23407129,Antonio Banderas,3,Donald E. Westlake,592871
New Regency Pictures,30000000,Norman Jewison,-25643000,Whoopi Goldberg,9,Jeff Rothberg,4357000
CiBy 2000,19000000,Robert Altman,-17646176,Jennifer Jason Leigh,8,Robert Altman,1353824
Motion Picture Corporation of America (MPCA),5000000,Eric Schaeffer,-364656,Sarah Jessica Parker,3,Eric Schaeffer,4635344
Twentieth Century Fox Film Corporation,7000000,Christopher Hampton,-6893394,Bob Hoskins,11,Joseph Conrad,106606
Castle Rock Entertainment,6000000,Lee David Zlotoff,6643776,Alison Elliott,9,Lee David Zlotoff,12643776
Triumph Films,19000000,Norberto Barba,-14067085,Mario Van Peebles,8,Robert Mason,4932915
Twentieth Century Fox Film Corporation,200000000,James Cameron,458672302,Leonardo DiCaprio,12,James Cameron,658672302
Be Gentlemen Limited Partnership,10000000,Gus Van Sant,128433435,Robin Williams,1,Matt Damon,138433435
Gaumont,93000000,Luc Besson,-29459980,Bruce Willis,5,Luc Besson,63540020
Tig Productions,80000000,Kevin Costner,-62373766,Kevin Costner,12,David Brin,17626234
Walt Disney Pictures,85000000,Ron Clements,14046791,Tate Donovan,6,Ron Clements,99046791
Melampo Cinematografica,20000000,Roberto Benigni,37598247,Roberto Benigni,2,Vincenzo Cerami,57598247
TriStar Pictures,105000000,Paul Verhoeven,-50185623,Casper Van Dien,11,Edward Neumeier,54814377
Warner Bros.,90000000,Robert Zemeckis,10920329,Jodie Foster,7,James V. Hart,100920329
Guild,62000000,Adrian Lyne,-60600000,Jeremy Irons,9,Vladimir Nabokov,1400000
Touchstone Pictures,75000000,Simon West,26117573,Nicolas Cage,6,Scott Rosenberg,101117573
New Line Cinema,15000000,Paul Thomas Anderson,11400640,Mark Wahlberg,10,Paul Thomas Anderson,26400640
Columbia Pictures Corporation,90000000,Barry Sonnenfeld,160690539,Tommy Lee Jones,7,Lowell Cunningham,250690539
Regency Enterprises,35000000,Curtis Hanson,29616940,Kevin Spacey,9,James Ellroy,64616940
Warner Bros.,125000000,Joel Schumacher,-17674805,Arnold Schwarzenegger,6,Bob Kane,107325195
Permut Presentations,80000000,John Woo,32225777,John Travolta,6,Mike Werb,112225777
Polygram Filmed Entertainment,50000000,David Fincher,-1676352,Michael Douglas,9,John Brancato,48323648
Columbia Pictures Corporation,36000000,Andrew Niccol,-23660367,Ethan Hawke,10,Andrew Niccol,12339633
Warner Bros.,57000000,Taylor Hackford,3984028,Keanu Reeves,10,Andrew Neiderman,60984028
Mandalay Entertainment,17000000,Jim Gillespie,55586134,Jennifer Love Hewitt,10,Lois Duncan,72586134
Miramax,12000000,Quentin Tarantino,27673162,Pam Grier,12,Quentin Tarantino,39673162
Brandywine Productions,75000000,Jean-Pierre Jeunet,-27251390,Sigourney Weaver,11,Dan O'Bannon,47748610
Universal Pictures,73000000,Steven Spielberg,156086679,Jeff Goldblum,5,Michael Crichton,229086679
Golar Productions,60000000,Paul W.S. Anderson,-33326758,Laurence Fishburne,8,Philip Eisner,26673242
Eon Productions,110000000,Roger Spottiswoode,15332007,Pierce Brosnan,12,Bruce Feirstein,125332007
Twentieth Century Fox Film Corporation,50000000,Don Bluth,8406347,Meg Ryan,11,Susan Gauthier,58406347
Twentieth Century Fox Film Corporation,90000000,Mick Jackson,-40676532,Tommy Lee Jones,4,Jerome Armstrong,49323468
Mandalay Entertainment,35000000,Mike Newell,6909762,Al Pacino,2,Joseph D. Pistone,41909762
TriStar Pictures,50000000,James L. Brooks,98478011,Jack Nicholson,12,Mark Andrus,148478011
Capella International,17000000,Jay Roach,36883989,Mike Myers,5,Mike Myers,53883989
October Films,15000000,David Lynch,-11203301,Bill Pullman,2,David Lynch,3796699
Constellation Entertainment,40000000,Francis Ford Coppola,5856732,Matt Damon,11,John Grisham,45856732
Universal Pictures,45000000,Tom Shadyac,136410615,Jim Carrey,3,Paul Guay,181410615
Universal Pictures,116000000,Roger Donaldson,-48872240,Pierce Brosnan,2,Leslie Bohem,67127760
Q Productions,20000000,Gregory Nava,15422828,Jennifer Lopez,3,Gregory Nava,35422828
New Line Cinema,40000000,Mark A.Z. Dippé,14967359,John Leguizamo,8,Todd McFarlane,54967359
TriStar Pictures,46000000,P.J. Hogan,81120029,Julia Roberts,6,Ronald Bass,127120029
Dimension Films,24000000,Wes Craven,77363301,Neve Campbell,12,Kevin Williamson,101363301
Cinema Line Film Corporation,45000000,Luis Llosa,20885767,Jon Voight,4,Hans Bauer,65885767
Fine Line Features,1300000,Harmony Korine,-1280180,Nick Sutton,11,Harmony Korine,19820
DreamWorks,36000000,Steven Spielberg,8175394,Djimon Hounsou,12,David Franzoni,44175394
Walt Disney Pictures,55000000,Sam Weisman,50263257,Brendan Fraser,7,Jay Ward,105263257
Columbia Pictures Corporation,85000000,Wolfgang Petersen,87956409,Harrison Ford,7,Andrew W. Marlowe,172956409
Dimension Films,30000000,Guillermo del Toro,-4519510,Mira Sorvino,8,Donald A. Wollheim,25480490
Twentieth Century Fox Film Corporation,32000000,Raja Gosnell,-1117485,Alex D. Linz,12,John Hughes,30882515
Kuzui Enterprises,1000000,Trey Parker,-417976,Trey Parker,10,Trey Parker,582024
Polygram Filmed Entertainment,22000000,Mel Smith,23319423,Rowan Atkinson,11,Rowan Atkinson,45319423
Mandalay Entertainment,70000000,Jean-Jacques Annaud,-32042318,Brad Pitt,10,Heinrich Harrer,37957682
The Institute for the Intellectual Development of Children & Young Adults,180000,Majid Majidi,745402,Mohammad Amir Naji,1,Majid Majidi,925402
Hollywood Pictures,15000000,George Armitage,13014536,John Cusack,4,Tom Jankiewicz,28014536
Caravan Pictures,50000000,Ridley Scott,-1830844,Demi Moore,8,Danielle Alexandra,48169156
Redwave Films,3500000,Peter Cattaneo,42450122,Robert Carlyle,9,Simon Beaufoy,45950122
Paramount Pictures,27000000,Gary Fleder,33527873,Morgan Freeman,10,James Patterson,60527873
Too Askew Prod. Inc.,250000,Kevin Smith,11756514,Ben Affleck,4,Kevin Smith,12006514
Columbia Pictures Corporation,25000000,Bob Spiers,4342592,Melanie Brown,1,Spice Girls,29342592
Castle Rock Entertainment,50000000,Clint Eastwood,7168,Clint Eastwood,2,David Baldacci,50007168
New Line Cinema,30000000,John R. Leonetti,5927406,Robin Shou,11,Ed Boon,35927406
Miramax,10000000,James Mangold,34886089,Sylvester Stallone,8,James Mangold,44886089
Paramount Pictures,35000000,Frank Oz,28856929,Kevin Kline,9,Paul Rudnick,63856929
Fox Searchlight Pictures,18000000,Ang Lee,-10162368,Kevin Kline,11,Rick Moody,7837632
Universal Pictures,60000000,Michael Caton-Jones,-5069720,Bruce Willis,11,Kenneth Ross,54930280
Phoenix Pictures,19000000,Oliver Stone,-12366600,Sean Penn,10,John Ridley,6633400
Paramount Pictures,20000000,Betty Thomas,21198146,Howard Stern,3,Howard Stern,41198146
Paramount Pictures,9000000,Brian Robbins,14687907,Kel Mitchell,7,Dan Schneider,23687907
Warner Bros.,35000000,Clint Eastwood,-9921063,John Cusack,11,John Berendt,25078937
Baltimore Pictures,15000000,Barry Levinson,28022524,Dustin Hoffman,1,Larry Beinhart,43022524
Paramount Pictures,68000000,Phillip Noyce,-6644564,Val Kilmer,4,Leslie Charteris,61355436
Blue Tulip Productions,160000000,Jan de Bont,-111391934,Sandra Bullock,6,Graham Yost,48608066
Warner Bros.,25000000,Stephen Kessler,11429528,Chevy Chase,2,Elisa Bell,36429528
Columbia Pictures Corporation,86000000,Alan J. Pakula,-43131652,Harrison Ford,3,Kevin Jarre,42868348
Warner Bros.,75000000,Richard Donner,982834,Mel Gibson,8,Brian Helgeland,75982834
Polygram Filmed Entertainment,29000000,Peter Hewitt,-6640707,John Goodman,2,Mary Norton,22359293
Walt Disney Pictures,32000000,John Pasquin,27925026,Tim Allen,3,Hervé Palud,59925026
Dino De Laurentiis Company,36000000,Jonathan Mostow,14129186,Kurt Russell,5,Jonathan Mostow,50129186
Walt Disney Pictures,80000000,Les Mayfield,12977226,Robin Williams,11,Samuel W. Taylor,92977226
DreamWorks,38000000,Gore Verbinski,23917389,Nathan Lane,12,Adam Rifkin,61917389
3 Arts Entertainment,10000000,Glenn Gordon Caron,21058643,Jennifer Aniston,8,Arleen Sorkin,31058643
DreamWorks,50000000,Mimi Leder,-8736860,George Clooney,9,Leslie Cockburn,41263140
United Artists,30000000,Bill Duke,-6538987,Laurence Fishburne,8,Chris Brancato,23461013
DC Entertainment,16000000,Kenneth Johnson,-14289028,Shaquille O'Neal,8,Louise Simonson,1710972
British Broadcasting Corporation (BBC),10000000,Brian Gilbert,-7842299,Stephen Fry,5,Richard Ellmann,2157701
Hollywood Pictures,22000000,Anthony Waller,4570463,Tom Everett Scott,12,John Landis,26570463
Image Organization,5000000,Robert Kurtzman,10719109,Tammy Lauren,9,Peter Atkins,15719109
Warner Bros.,60000000,Félix Enríquez Alcalá,-43771552,Steven Seagal,9,Jeb Stuart,16228448
Walt Disney Pictures,3000000,Charles Martin Smith,21629916,Michael Jeter,8,Kevin DiCicco,24629916
British Broadcasting Corporation (BBC),40000000,Peter Hyams,-6043392,Penelope Ann Miller,1,Douglas Preston,33956608
Fox 2000 Pictures,7500000,George Tillman Jr.,35990057,Vanessa Williams,9,George Tillman Jr.,43490057
New Line Cinema,25000000,Brett Ratner,16067398,Charlie Sheen,8,Joel Cohen,41067398
Pacific Western,37000000,Jeb Stuart,-30517805,Danny Glover,10,Jeb Stuart,6482195
New Amsterdam Entertainment,1000000,Mark Pavia,-874603,Miguel Ferrer,2,Stephen King,125397
Sweetland Films,20000000,Woody Allen,-9430929,Woody Allen,1,Woody Allen,10569071
Touchstone Pictures,25000000,Steve Oedekerk,19455658,Martin Lawrence,7,Steve Oedekerk,44455658
De Fina-Cappa,28000000,Martin Scorsese,-22467699,Tenzin Thuthob Tsarong,1,Melissa Mathison,5532301
Mandalay Entertainment,30000000,Hark Tsui,-18561663,Jean-Claude Van Damme,4,Don Jakoby,11438337
Columbia Pictures Corporation,20000000,Marco Brambilla,-5672794,Alicia Silverstone,8,Max D. Adams,14327206
Fox Searchlight Pictures,1000000,James Toback,950218,Robert Downey Jr.,4,James Toback,1950218
Channel Four Films,12000000,Danny Boyle,-7733757,Cameron Diaz,10,John Hodge,4266243
Icon Entertainment International,35000000,Bernard Rose,-34208170,Sophie Marceau,4,Leo Tolstoy,791830
Beacon Communications,12000000,Andy Wilson,-7947653,David Duchovny,10,Mark Haskell Smith,4052347
China Film Co-Production Corporation,35000000,Ronny Yu,-28551183,Angus Macfadyen,5,Michael Vickerman,6448817
Metro-Goldwyn-Mayer (MGM),48000000,Jon Avnet,-25584560,Richard Gere,10,Robert King,22415440
Warner Bros.,20000000,Jon Amiel,-6198245,Bill Murray,11,Robert Farrar,13801755
Warner Bros.,25000000,John Singleton,-11895506,Jon Voight,2,Gregory Poirier,13104494
Miramax,18000000,Nick Cassavetes,-10778164,Sean Penn,8,John Cassavetes,7221836
Universal Pictures,25000000,Fred Schepisi,-15618740,John Cleese,1,John Cleese,9381260
Live Entertainment,5000000,Peter O'Fallon,-3307128,Christopher Walken,4,Josh McKinney,1692872
Hollywood Pictures,8000000,Steve James,-7467810,Jared Leto,1,Steve James,532190
Universal Pictures,28000000,Michael Ritchie,-19880795,Martin Short,7,Jeff Rothberg,8119205
Walt Disney Pictures,30000000,Stanley Tong,-8617544,Leslie Nielsen,12,Pat Proft,21382456
Icon Entertainment International,20000000,Kevin Reynolds,-14283920,Samuel L. Jackson,7,Scott Yagemann,5716080
David Kirschner Productions,32000000,Mark Dindal,-28437251,Scott Bakula,3,Mark Dindal,3562749
JVC Entertainment Networks,6000000,Paul Schrader,302154,Nick Nolte,2,Russell Banks,6302154
Trimark Pictures,6000000,Kasi Lemmons,8821531,Samuel L. Jackson,11,Kasi Lemmons,14821531
Saban Entertainment,8000000,Shuki Levy,109349,Jason David Frank,3,Shuki Levy,8109349
Warner Bros.,50000000,Costa-Gavras,-39443804,John Travolta,11,Tom Matthews,10556196
Agenda,3300000,Kevin Allen,-3225812,Llyr Ifans,5,Kevin Allen,74188
Touchstone Pictures,55000000,Thomas Carter,-23012437,Eddie Murphy,1,Randy Feldman,31987563
Miramax,9000000,Michael Winterbottom,-8660352,Stephen Dillane,11,Michael Nicholson,339648
Bubble Factory The,17000000,Paul Miller,-13493794,John Leguizamo,2,David Bar Katz,3506206
Bavaria Film,35000000,Bille August,-32778006,Julia Ormond,2,Peter Høeg,2221994
Butcher's Run Films,5000000,Robert Duvall,15733485,Robert Duvall,2,Robert Duvall,20733485
New Line Cinema,24000000,Mike Figgis,-21381665,Wesley Snipes,11,Mike Figgis,2618335
Northern Lights Entertainment,85000000,Ivan Reitman,-56340396,Robin Williams,5,Francis Veber,28659604
Universal Pictures,35000000,Bryan Spicer,-3388775,Tim Allen,12,Jana Howington,31611225
Bandeira Entertainment,1500000,Mark Waters,-882597,Parker Posey,10,Wendy MacLeod,617403
Orion Pictures,3000000,Tom Schulman,559990,Joe Pesci,4,Tom Schulman,3559990
Jasmine Productions Inc.,10000000,David Mamet,200000,Steve Martin,5,David Mamet,10200000
Caravan Pictures,53000000,Christopher Cain,-33263068,Joe Pesci,5,Jill Mazursky,19736932
Largo Entertainment,8000000,John Irvin,-6504668,Harvey Keitel,3,Ken Solarz,1495332
Daybreak,15000000,George Huang,-14999691,Will Friedle,10,Andy Burg,309
All Net Productions,11000000,Randall Miller,3708874,Marlon Wayans,3,Christopher Reed,14708874
Bubble Factory The,31190000,Bryan Spicer,-26660157,Tom Arnold,4,Peter Crabbe,4529843
Addis Wechsler Pictures,10000000,Theodore Witcher,2514138,Larenz Tate,3,Theodore Witcher,12514138
Alliance Atlantis Communications,25000,Neil LaBute,2831622,Aaron Eckhart,8,Neil LaBute,2856622
Robert Simonds Productions,15000000,Andy Cadiff,-4286395,Christopher McDonald,8,Bob Mosher,10713605
JLT Productions,12000000,Manny Coto,-4984760,Joseph Mazzello,1,Manny Coto,7015240
High School Sweethearts,16000000,Ken Kwapis,-4513120,Fran Drescher,2,Todd Graff,11486880
Rank Organisation The,7000000,John Duigan,-6893708,Sam Rockwell,5,Naomi Wallace,106292
Paramount Pictures,18000000,Keith Samples,-14752476,Greg Kinnear,8,Kevin Meyer,3247524
Lakeshore Entertainment,1000000,Scott Winant,2478370,Jeanne Tripplehorn,5,Winnie Holzman,3478370
Samson Productions Pty. Ltd.,16000000,Bruce Beresford,-14078529,Glenn Close,4,David Giles,1921471
Clinica Estetico,2700000,Victor Nunez,6354736,Peter Fonda,7,Victor Nunez,9054736
Cinergi Pictures Entertainment,45000000,George P. Cosmatos,-42845460,Charlie Sheen,1,Adi Hasak,2154540
Metro-Goldwyn-Mayer (MGM),71000000,Robert Butler,-59533912,Ray Liotta,1,Jonathan Brett,11466088
Ivory Way Productions,25000000,David Hogan,-18679724,Keenen Ivory Wayans,10,Keenen Ivory Wayans,6320276
Gruber Bros,3000000,Stefan Schwartz,-2697796,Dan Futterman,5,Stefan Schwartz,302204
CiBy 2000,5000000,Wim Wenders,-4716967,Traci Lind,9,Nicholas Klein,283033
Bates Entertainment,4000000,Stephen Kay,-3953638,Thomas Jane,6,Neal Cassady,46362
Cinergi Pictures Entertainment,10000000,Arthur Hiller,-9954221,Ryan O'Neal,2,Joe Eszterhas,45779
First Floor Features,4500000,Mike van Diem,-3786587,Pavlik Jansen op de Haar,3,Ferdinand Bordewijk,713413
DreamWorks,70000000,Steven Spielberg,146540909,Tom Hanks,7,Robert Rodat,216540909
Polygram Filmed Entertainment,15000000,Joel Coen,2451873,Jeff Bridges,3,Ethan Coen,17451873
New Line Cinema,7500000,Tony Kaye,-780136,Edward Norton,11,David McKenna,6719864
Walt Disney Feature Animation Florida,90000000,Tony Bancroft,30620254,Ming-Na Wen,6,Robert D. San Souci,120620254
Touchstone Pictures,140000000,Michael Bay,61573391,Bruce Willis,7,Jonathan Hensleigh,201573391
Paramount Pictures,60000000,Peter Weir,65618201,Jim Carrey,6,Andrew Niccol,125618201
Harvest Filmworks,60000,Darren Aronofsky,3156970,Sean Gullette,7,Darren Aronofsky,3216970
Twentieth Century Fox Film Corporation,23000000,Bobby Farrelly,153484651,Ben Stiller,7,Ed Decter,176484651
Amen Ra Films,45000000,Stephen Norrington,25087718,Wesley Snipes,8,David S. Goyer,70087718
Midwinter Productions Inc.,25000000,Ronny Yu,7383850,Jennifer Tilly,10,Don Mancini,32383850
Universal Pictures,90000000,Martin Brest,-45380900,Brad Pitt,11,Ron Osborn,44619100
DiNovi Pictures,48000000,Griffin Dunne,-1316623,Sandra Bullock,10,Alice Hoffman,46683377
Universal Pictures,60000000,Harold Becker,-27059493,Bruce Willis,4,Ryne Douglas Pearson,32940507
Fox 2000 Pictures,52000000,Terrence Malick,-15599509,Jim Caviezel,1,James Jones,36400491
Mystery Clock Cinema,27000000,Alex Proyas,-12621669,Rufus Sewell,2,Alex Proyas,14378331
Mandalay Entertainment,20000000,John McNaughton,9753944,Kevin Bacon,3,Stephen Peters,29753944
FGM Entertainment,55000000,John Frankenheimer,-13383738,Robert De Niro,9,J.D. Zeik,41616262
Fear and Loathing LLC,18500000,Terry Gilliam,-7819725,Johnny Depp,5,Hunter S. Thompson,10680275
Universal Pictures,25000000,John Madden,75317794,Gwyneth Paltrow,1,Marc Norman,100317794
New Line Cinema,33000000,Brett Ratner,108153686,Jackie Chan,9,Ross LaManna,141153686
Warner Bros.,65000000,Nora Ephron,50821495,Tom Hanks,12,Miklós László,115821495
Robert Simonds Productions,20000000,Frank Coraci,141491646,Adam Sandler,11,Tim Herlihy,161491646
Paramount Pictures,75000000,Mimi Leder,65464664,Robert Duvall,5,Bruce Joel Rubin,140464664
New Line Cinema,80000000,Stephen Hopkins,-10882371,Gary Oldman,4,Irwin Allen,69117629
Pixar Animation Studios,120000000,John Lasseter,42798565,Kevin Spacey,11,John Lasseter,162798565
American Empirical Pictures,9000000,Wes Anderson,8105219,Jason Schwartzman,2,Wes Anderson,17105219
DreamWorks Animation,70000000,Brenda Chapman,31217900,Val Kilmer,12,Philip LaZebnik,101217900
Dimension Films,15000000,Robert Rodriguez,25064955,Jordana Brewster,12,David Wechter,40064955
Touchstone Pictures,90000000,Tony Scott,21549836,Will Smith,11,David Marconi,111549836
Polygram Filmed Entertainment,85000000,Vincent Ward,-29514957,Robin Williams,10,Richard Matheson,55485043
Universal Pictures,48000000,Steven Soderbergh,-10437432,George Clooney,6,Elmore Leonard,37562568
Film Office,20000000,John Carpenter,241395,James Woods,10,John Steakley,20241395
TriStar Pictures,65000000,Martin Campbell,29095523,Antonio Banderas,7,Johnston McCulley,94095523
United Artists Corporation,35000000,Randall Wallace,21968902,Leonardo DiCaprio,3,Alexandre Dumas,56968902
Twentieth Century Fox Film Corporation,26000000,Andy Tennant,39705771,Drew Barrymore,7,Susannah Grant,65705771
Juno Pix,18000000,Frank Coraci,62245725,Adam Sandler,2,Tim Herlihy,80245725
Universal Pictures,60000000,Gus Van Sant,-38543870,Vince Vaughn,12,Robert Bloch,21456130
Dimension Films,17000000,Steve Miner,38041738,Jamie Lee Curtis,8,Debra Hill,55041738
Caravan Pictures,70000000,Ivan Reitman,4329966,Harrison Ford,6,Michael Browning,74329966
Metro-Goldwyn-Mayer (MGM),15000000,David Nutter,2411331,James Marsden,7,Scott Rosenberg,17411331
Centropolis Film Productions,130000000,Roland Emmerich,6314294,Matthew Broderick,5,Dean Devlin,136314294
New Line Cinema,40000000,Gary Ross,568025,Tobey Maguire,10,Gary Ross,40568025
Twentieth Century Fox Film Corporation,30000000,Forest Whitaker,30053195,Sandra Bullock,5,Steven Rogers,60053195
Warner Bros.,60000000,Paul W.S. Anderson,-45432117,Kurt Russell,10,David Webb Peoples,14567883
Universal Pictures,40000000,Joe Dante,14682547,Kirsten Dunst,7,Gavin Scott,54682547
Miramax,12000000,John Dahl,10905674,Matt Damon,9,David Levien,22905674
Columbia Pictures Corporation,10000000,Harry Elfont,15339117,Jennifer Love Hewitt,6,Deborah Kaplan,25339117
Warner Bros.,60000000,Stuart Baird,-2832595,Tommy Lee Jones,3,Roy Huggins,57167405
Next Wave Films,6000,Christopher Nolan,42482,Jeremy Theobald,11,Christopher Nolan,48482
PolyGram Filmed Entertainment,30000000,Shekhar Kapur,82699,Cate Blanchett,2,Michael Hirst,30082699
Art Linson Productions,25000000,Alfonso Cuarón,1333044,Ethan Hawke,1,Charles Dickens,26333044
Robert Simonds Productions,8000000,Tamra Davis,9278980,Dave Chappelle,1,Dave Chappelle,17278980
Phoenix Pictures,14000000,Jamie Blanks,24072438,Jared Leto,9,Silvio Horta,38072438
Paramount Pictures,58000000,Jonathan Frakes,12117571,Patrick Stewart,12,Gene Roddenberry,70117571
Universal Pictures,28000000,John Landis,-14020401,Dan Aykroyd,2,Dan Aykroyd,13979599
Broadway Pictures,17000000,John Fortenberry,13324946,Chris Kattan,10,Steve Koren,30324946
TriStar Pictures,50000000,Chris Columbus,41137662,Julia Roberts,12,Gigi Levangie,91137662
Warner Bros.,140000000,Richard Donner,-9555397,Mel Gibson,7,Shane Black,130444603
Universal Pictures,90000000,Tom Shadyac,45026902,Robin Williams,12,Patch Adams,135026902
Warner Bros.,60000000,Jeremiah S. Chechik,-36677168,Ralph Fiennes,8,Sydney Newman,23322832
Twentieth Century Fox Film Corporation,71500000,Betty Thomas,72656605,Eddie Murphy,6,Hugh Lofting,144156605
DreamWorks,105000000,Eric Darnell,-14242137,Woody Allen,10,Todd Alcott,90757863
Paramount Pictures,73000000,Brian De Palma,-17414611,Nicolas Cage,8,Brian De Palma,55585389
Regency Enterprises,50000000,F. Gary Gray,-5515935,Samuel L. Jackson,7,James DeMonaco,44484065
Columbia Pictures,24000000,Danny Cannon,16002112,Jennifer Love Hewitt,11,Lois Duncan,40002112
Twentieth Century Fox Film Corporation,66000000,Rob Bowman,17898313,David Duchovny,6,Chris Carter,83898313
Phoenix Pictures,14000000,Bryan Singer,-5161062,Ian McKellen,10,Stephen King,8838938
Good Machine,3000000,Todd Solondz,-192610,Jane Adams,10,Todd Solondz,2807390
Atlas Entertainment,55000000,Brad Silberling,23685114,Nicolas Cage,4,Wim Wenders,78685114
Dollface,13000000,Mark Christopher,3574731,Ryan Phillippe,8,Mark Christopher,16574731
Cinépix Film Properties (CFP),1500000,Vincent Gallo,875097,Vincent Gallo,6,Vincent Gallo,2375097
Warner Bros.,60000000,Andrew Davis,7638368,Michael Douglas,6,Frederick Knott,67638368
Intermedia Films,9000000,Peter Howitt,2883495,Gwyneth Paltrow,5,Peter Howitt,11883495
Warner Bros.,80000000,Barry Levinson,-42979723,Dustin Hoffman,2,Michael Crichton,37020277
Twentieth Century Fox Film Corporation,70000000,Edward Zwick,-29018711,Denzel Washington,11,Lawrence Wright,40981289
Rhombus Media,10000000,François Girard,-526618,Carlo Cecchi,6,Don McKellar,9473382
Touchstone Pictures,60000000,Robert Redford,15383563,Robert Redford,5,Nick Evans,75383563
Regency Enterprises,8000000,Marshall Herskovitz,-3469071,Catherine McCormack,2,Margaret Rosenthal,4530929
Sciarlò,9000000,Giuseppe Tornatore,-8740873,Tim Roth,1,Alessandro Baricco,259127
Columbia Pictures Corporation,30000000,Antoine Fuqua,-11032429,Yun-Fat Chow,2,Ken Sanzel,18967571
Paramount Pictures,24000000,Igor Kovalyov,76494675,Elizabeth Daily,11,David N. Weiss,100494675
Twentieth Century Fox Film Corporation,30000000,Warren Beatty,-3474166,Warren Beatty,5,Warren Beatty,26525834
Nimbus Film Productions,1300000,Thomas Vinterberg,347780,Ulrich Thomsen,6,Thomas Vinterberg,1647780
Initial Entertainment Group (IEG),10000000,Peter Berg,-198218,Christian Slater,11,Peter Berg,9801782
Warner Bros.,85000000,Troy Miller,-50454970,Michael Keaton,12,Mark Steven Johnson,34545030
New Line Cinema,4500000,Ice Cube,18531390,LisaRaye McCoy,4,Ice Cube,23031390
Touchstone Pictures,25000000,Spike Lee,-3445415,Denzel Washington,5,Spike Lee,21554585
Metro-Goldwyn-Mayer (MGM),13000000,Bob Saget,-3024316,Norm MacDonald,6,Frank Sebastiano,9975684
Calimari Productions,45000000,Stephen Sommers,-33796974,Treat Williams,1,Stephen Sommers,11203026
British Broadcasting Corporation (BBC),17000000,Sam Raimi,-688237,Bill Paxton,1,Scott B. Smith,16311763
Zentropa Entertainments,2500000,Lars von Trier,-2492765,Bodil Jørgensen,5,Lars von Trier,7235
Monarch Pictures,30000000,Carl Franklin,-6754160,Meryl Streep,9,Anna Quindlen,23245840
TriStar Pictures,13000000,Kirk Wong,14052167,Mark Wahlberg,4,Ben Ramsey,27052167
Warner Bros.,40000000,Frederik Du Chau,-17282242,Jessalyn Gilsig,5,Vera Chapman,22717758
Hollywood Pictures,30000000,Mark Steven Johnson,-11747316,Ian Michael Smith,9,Mark Steven Johnson,18252684
RKO Pictures,90000000,Ron Underwood,-39367963,Bill Paxton,12,Merian C. Cooper,50632037
Twentieth Century Fox Film Corporation,27000000,Richard Linklater,-16702103,Matthew McConaughey,3,Claude Stanush,10297897
ShadowCatcher Entertainment,2000000,Chris Eyre,4719300,Adam Beach,6,Sherman Alexie,6719300
Big Dog Films,3000000,Hype Williams,6630169,Nas,11,Anthony Bodden,9630169
Sweetland Films,12000000,Woody Allen,-6967504,Kenneth Branagh,11,Woody Allen,5032496
Rysher Entertainment,5000000,Don Roos,881367,Christina Ricci,5,Don Roos,5881367
Touchstone Pictures,75000000,Steven Zaillian,-18297099,John Travolta,1,Jonathan Harr,56702901
Oriental Light and Magic (OLM),30000000,Kunihiko Yuyama,55744662,Veronica Taylor,11,Satoshi Tajiri,85744662
Twentieth Century Fox Film Corporation,15000000,Nicholas Hytner,14106737,Jennifer Aniston,4,Stephen McCauley,29106737
British Broadcasting Corporation (BBC) Television,70000000,Mikael Salomon,-50180506,Morgan Freeman,1,Graham Yost,19819494
Lions Gate Films,3500000,Bill Condon,2890032,Ian McKellen,11,Christopher Bram,6390032
Fox Searchlight Pictures,5000000,Tamara Jenkins,480318,Natasha Lyonne,9,Tamara Jenkins,5480318
Polar Entertainment,6000000,John Waters,-3718239,Edward Furlong,10,John Waters,2281761
Hyperion Pictures,14000000,Willard Carroll,-10043788,Gillian Anderson,1,Willard Carroll,3956212
Twentieth Century Fox Film Corporation,20000000,Kevin Rodney Sullivan,17672350,Angela Bassett,8,Terry McMillan,37672350
Harpo Films,80000000,Jonathan Demme,-57147513,Oprah Winfrey,10,Toni Morrison,22852487
Tomboy Films,3000000,Kirk Jones,21788807,Ian Bannen,1,Kirk Jones,24788807
Award Entertainment,65000000,Mike Nichols,-26033943,John Travolta,3,Joe Klein,38966057
Mandalay Entertainment,50000000,Barbet Schroeder,-36193863,Michael Keaton,1,David Klass,13806137
Turner Pictures (I),30000000,Christopher Guest,-23885072,Chris Farley,5,Mark Nutter,6114928
Tapestry Films,10000000,Jim Abrahams,9882538,Jay Mohr,7,Jim Abrahams,19882538
Kennedy Miller Productions,80000000,George Miller,-61680140,Magda Szubanski,11,George Miller,18319860
Morgan Creek Productions,18000000,John Warren,-14448792,Scott Bakula,4,David S. Ward,3551208
Castle Rock Entertainment,8000000,Whit Stillman,-5012703,Chloë Sevigny,6,Whit Stillman,2987297
Paramount Pictures,14000000,Alan Cohn,1062898,Tom Everett Scott,8,Anthony Abrams,15062898
Enchanter Entertainment,25000000,Robert Altman,-23465431,Kenneth Branagh,1,John Grisham,1534569
Cinehaus,20000000,Robert Benton,-4969268,Paul Newman,3,Robert Benton,15030732
Cruise/Wagner Productions,25000000,Robert Towne,-24222577,Billy Crudup,9,Robert Towne,777423
Chinese Bookie Pictures,4500000,Larry Clark,-3474766,James Woods,6,Eddie Little,1025234
Shooting Gallery,1100000,John Pieplow,-468779,Kevin Gage,10,Dee Snider,631221
Dimension Films,15000000,Penelope Spheeris,-1964401,Marlon Wayans,2,Greg Erb,13035599
Knock Films A.V.V.,35000000,Hark Tsui,-24923864,Jean-Claude Van Damme,9,Steven E. de Souza,10076136
DreamWorks,23000000,John Roberts,4008669,Gena Rowlands,4,Laurie Craig,27008669
Dieter Geissler Filmproduktion,20000000,Carl Schenkel,-17852886,Casper Van Dien,4,Edgar Rice Burroughs,2147114
AMLF,12000000,Gillies MacKinnon,-10737214,Kate Winslet,1,Esther Freud,1262786
Miramax,7000000,M. Night Shyamalan,-6741788,Joseph Cross,3,M. Night Shyamalan,258212
Polygram Filmed Entertainment,15000000,Steve Gomer,-3855482,George Hearn,4,Stephen White,11144518
Audiovisual Development Bureau Ministerio da Cultura,2900000,Walter Salles,2695428,Fernanda Montenegro,11,Marcos Bernstein,5595428
Caravan Pictures,60000000,Stephen Herek,-47934015,Eddie Murphy,10,Tom Schulman,12065985
Castle Rock Entertainment,5000000,Jake Kasdan,-3019662,Bill Pullman,1,Jake Kasdan,1980338
Twentieth Century Fox Film Corporation,19000000,Dean Semler,-10958335,Howie Long,1,Chris Soth,8041665
Arts Council of England,7000000,Anand Tucker,-2125162,Emily Watson,2,Hilary du Pré,4874838
Walt Disney Pictures,30000000,Arlene Sanford,-17786322,Jonathan Taylor Thomas,11,Tom Nursall,12213678
HK Film Corporation,6000000,Tony Cinciripini,-5990878,Rosanna Arquette,1,Tony Cinciripini,9122
Blue Streak Films,700000,David Moreton,170751,Chris Stafford,4,Todd Stephens,870751
Polygram Filmed Entertainment,5000000,Neil LaBute,-289251,Amy Brenneman,8,Neil LaBute,4710749
Fade In Films,8000000,David Dobkin,-6210108,Joaquin Phoenix,9,Matthew L. Healy,1789892
Regency Enterprises,20000000,Roland Joffé,-18076939,Patricia Arquette,4,Ron Peer,1923061
Andell Entertainment,1000000,John Hamburg,-978790,Sam Rockwell,8,John Hamburg,21210
Baltimore Pictures,15000000,Dean Parisot,-4556684,Drew Barrymore,11,Vince Gilligan,10443316
DIC Entertainment,24000000,Steve Boyum,-19691019,Paul Walker,3,Jim Herzfeld,4308981
Gotham Entertainment Group,13000000,Daisy von Scherler Mayer,-4973029,Jada Pinkett Smith,5,David C. Johnson,8026971
HSX Films,2000000,Lance Mungia,-1875506,Jeffrey Falcon,9,Jeffrey Falcon,124494
Artisan Entertainment,3500000,Neil Abramson,5747881,Jerry Springer,11,Jon Bernstein,9247881
Initial Entertainment Group (IEG),10000000,Predrag Antonijevic,-9987097,Dennis Quaid,11,Robert Orr,12903
38 Productions,800000,Ziad Doueiri,-456771,Rami Doueiri,10,Ziad Doueiri,343229
Fox 2000 Pictures,63000000,David Fincher,-25969898,Brad Pitt,10,Chuck Palahniuk,37030102
DreamWorks,15000000,Sam Mendes,115096601,Kevin Spacey,10,Alan Ball,130096601
Warner Bros.,63000000,Lana Wachowski,108479930,Keanu Reeves,3,Lilly Wachowski,171479930
Castle Rock Entertainment,60000000,Frank Darabont,76801374,Tom Hanks,12,Stephen King,136801374
Universal Pictures,11000000,Paul Weitz,91561004,Jason Biggs,7,Adam Herz,102561004
Warner Bros.,65000000,Stanley Kubrick,-9308792,Tom Cruise,7,Stanley Kubrick,55691208
Universal Pictures,80000000,Stephen Sommers,75247825,Brendan Fraser,5,Stephen Sommers,155247825
Hollywood Pictures,40000000,M. Night Shyamalan,253506292,Bruce Willis,8,M. Night Shyamalan,293506292
Touchstone Pictures,30000000,Gil Junger,8176108,Heath Ledger,3,Karen McCullah,38176108
Paramount Pictures,100000000,Tim Burton,1071502,Johnny Depp,11,Washington Irving,101071502
Lucasfilm,115000000,George Lucas,359544677,Ewan McGregor,5,George Lucas,474544677
Warner Bros.,60000000,Renny Harlin,13648142,Thomas Jane,7,Duncan Kennedy,73648142
Twentieth Century Fox Film Corporation,10000000,Mike Judge,824921,Ron Livingston,2,Mike Judge,10824921
American Zoetrope,6000000,Sofia Coppola,-1140525,Kirsten Dunst,5,Jeffrey Eugenides,4859475
Columbia Pictures Corporation,10500000,Roger Kumble,27828567,Sarah Michelle Gellar,3,Choderlos de Laclos,38328567
DreamWorks,45000000,Dean Parisot,26583916,Tim Allen,12,David Howard,71583916
Ghoulardi Film Company,37000000,Paul Thomas Anderson,-14544024,Tom Cruise,1,Paul Thomas Anderson,22455976
New Line Cinema,33000000,Jay Roach,173040086,Mike Myers,6,Mike Myers,206040086
Fox 2000 Pictures,25000000,Raja Gosnell,30474756,Drew Barrymore,4,Abby Kohn,55474756
Franchise Pictures,7000000,Troy Duffy,-6974188,Willem Dafoe,11,Troy Duffy,25812
Columbia Pictures Corporation,40000000,James Mangold,-11128810,Winona Ryder,1,Susanna Kaysen,28871190
Pixar Animation Studios,90000000,John Lasseter,155852179,Tom Hanks,11,John Lasseter,245852179
Miramax,40000000,Anthony Minghella,41298265,Matt Damon,12,Patricia Highsmith,81298265
Peters Entertainment,170000000,Barry Sonnenfeld,-56194319,Will Smith,6,Jim Thomas,113805681
Polygram Filmed Entertainment,42000000,Roger Michell,74089678,Hugh Grant,5,Richard Curtis,116089678
Haxan Films,60000,Daniel Myrick,140479099,Heather Donahue,7,Daniel Myrick,140539099
Astralwerks,13000000,Spike Jonze,9858926,John Cusack,12,Charlie Kaufman,22858926
Jack Giarraputo Productions,34200000,Dennis Dugan,129279795,Adam Sandler,6,Steve Franks,163479795
Miramax,10000000,Robert Iscove,53366989,Freddie Prinze Jr.,1,R. Lee Fleming Jr.,63366989
Danjaq,135000000,Michael Apted,-8056316,Pierce Brosnan,11,Neal Purvis,126943684
Beacon Communications,100000000,Peter Hyams,-33110957,Arnold Schwarzenegger,11,Andrew W. Marlowe,66889043
View Askew Productions,10000000,Kevin Smith,20651422,Ben Affleck,11,Kevin Smith,30651422
Walt Disney Pictures,130000000,Chris Buck,41091819,Tony Goldwyn,6,Tab Murphy,171091819
MTV Films,16000000,Brian Robbins,36885587,James Van Der Beek,1,W. Peter Iliff,52885587
Universal Pictures,82000000,Milos Forman,-47419365,Jim Carrey,12,Scott Alexander,34580635
Twentieth Century Fox Film Corporation,66000000,Jon Amiel,21704396,Sean Connery,4,Ronald Bass,87704396
Warner Bros.,70000000,Brad Bird,-46840695,Eli Marienthal,8,Tim McCanlies,23159305
Happy Madison Productions,17000000,Mike Mitchell,48538755,Rob Schneider,12,Harris Goldberg,65538755
United Artists,48000000,John McTiernan,21304264,Pierce Brosnan,8,Alan Trustman,69304264
ETIC Films,12000000,Antonia Bird,-9939047,Guy Pearce,3,Ted Griffin,2060953
Imagine Entertainment,80000000,Ted Demme,-16155026,Eddie Murphy,4,Robert Ramsey,63844974
Universal Pictures,25000000,Joe Johnston,7481825,Jake Gyllenhaal,2,Homer H. Hickam Jr.,32481825
Touchstone Pictures,68000000,Michael Mann,-39034803,Russell Crowe,11,Marie Brenner,28965197
Warner Bros.,75000000,David O. Russell,-14347964,George Clooney,10,John Ridley,60652036
Artisan Entertainment,38000000,Roman Polanski,-19338664,Johnny Depp,3,Arturo Pérez-Reverte,18661336
Warner Bros.,55000000,Oliver Stone,20530832,Al Pacino,12,Daniel Pyne,75530832
1492 Pictures,100000000,Chris Columbus,-41779224,Robin Williams,12,Isaac Asimov,58220776
Universal Pictures,55000000,Frank Oz,11384775,Steve Martin,8,Steve Martin,66384775
Fox Searchlight Pictures,2000000,Kimberly Peirce,9533945,Hilary Swank,3,Kimberly Peirce,11533945
Touchstone Pictures,160000000,John McTiernan,-127301101,Antonio Banderas,8,Michael Crichton,32698899
Crossroads Films,3500000,Darren Stein,-428053,Rose McGowan,2,Darren Stein,3071947
Columbia Pictures Corporation,73000000,Phillip Noyce,-6481345,Denzel Washington,11,Jeffery Deaver,66518655
Paramount Pictures,70000000,Bruce Beresford,46741558,Ashley Judd,9,David Weisberg,116741558
Asymmetrical Productions,10000000,David Lynch,-3796956,Richard Farnsworth,11,John Roach,6203044
Bona Fide Productions,25000000,Alexander Payne,-10120444,Matthew Broderick,5,Tom Perrotta,14879556
Universal Pictures,68000000,Kinka Usher,-38344410,Ben Stiller,8,Neil Cuthbert,29655590
New Line Cinema,15000000,Michael Patrick Jann,-4438762,Kirsten Dunst,7,Lona Williams,10561238
FilmColony,24000000,Lasse Hallström,33545092,Tobey Maguire,1,John Irving,57545092
Fox 2000 Pictures,35000000,Steve Miner,-3229586,Bridget Fonda,7,David E. Kelley,31770414
Artisan Entertainment,12000000,David Koepp,9133087,Kevin Bacon,9,Richard Matheson,21133087
DreamWorks,80000000,Jan de Bont,11411151,Liam Neeson,7,David Self,91411151
Columbia Pictures Corporation,133000000,Rob Minkoff,7035367,Michael J. Fox,12,E.B. White,140035367
Forge,35000000,Hugh Wilson,-8505389,Brendan Fraser,2,Bill Kelly,26494611
Icon Entertainment International,90000000,Brian Helgeland,-8473879,Mel Gibson,2,Donald E. Westlake,81526121
Columbia Pictures,20000000,Doug Liman,-3157697,Sarah Polley,4,John August,16842303
Azoff Entertainment,50000000,Norman Jewison,668906,Denzel Washington,1,Rubin 'Hurricane' Carter,50668906
Columbia Pictures Corporation,40000000,Joel Schumacher,-3336685,Nicolas Cage,2,Andrew Kevin Walker,36663315
Dark Castle Entertainment,37000000,William Malone,3846082,Geoffrey Rush,10,Robb White,40846082
Paramount Pictures,95000000,Simon West,7705852,John Travolta,6,Nelson DeMille,102705852
Scott Rudin Productions,21000000,Trey Parker,31008288,Trey Parker,6,Trey Parker,52008288
New Line Cinema,75000000,Rand Ravich,-64327434,Charlize Theron,8,Rand Ravich,10672566
Columbia Pictures,16000000,Josef Rusnak,-500000,Craig Bierko,5,Daniel F. Galouye,15500000
Columbia Pictures Corporation,25000000,Rodman Flender,-20997045,Devon Sawa,4,Terri Hughes,4002955
Baldwin/Cohen Productions,28000000,Jay Roach,-19111857,Russell Crowe,10,David E. Kelley,8888143
Fox Searchlight Pictures,11000000,Michael Hoffman,5071990,Kevin Kline,5,William Shakespeare,16071990
Fox 2000 Pictures,25000000,Jonathan Kaplan,-14885685,Claire Danes,8,Adam Fields,10114315
Paramount Pictures,70000000,Garry Marshall,82257509,Julia Roberts,7,Josann McGibbon,152257509
40 Acres & A Mule Filmworks,22000000,Spike Lee,-2716218,John Leguizamo,7,Spike Lee,19283782
New Line Cinema,6500000,Adam Rifkin,-2282885,Edward Furlong,8,Carl V. Dupré,4217115
De Fina-Cappa,55000000,Martin Scorsese,-38359790,Nicolas Cage,10,Joe Connelly,16640210
Gaumont,85000000,Luc Besson,-70723683,Milla Jovovich,11,Andrew Birkin,14276317
United Artists,21000000,Katt Shea,-3237295,Emily Bergl,3,Stephen King,17762705
Village Roadshow Pictures,80000000,Harold Ramis,26885658,Robert De Niro,3,Kenneth Lonergan,106885658
Cheerleader LLC,1200000,Jamie Babbit,1005627,Natasha Lyonne,8,Brian Peterson,2205627
Bel Air Entertainment,80000000,Luis Mandoki,-27119984,Kevin Costner,2,Nicholas Sparks,52880016
Metro-Goldwyn-Mayer (MGM),29000000,Rupert Wainwright,21046268,Patricia Arquette,9,Tom Lazarus,50046268
Walt Disney Pictures,90000000,David Kellogg,7403112,Matthew Broderick,7,Andy Heyward,97403112
Tribeca Productions,15000000,Joel Schumacher,-10514515,Robert De Niro,11,Joel Schumacher,4485485
Twentieth Century Fox Film Corporation,8500000,John Schultz,9345337,Melissa Joan Hart,10,Todd Strasser,17845337
Universal Pictures,80000000,Sam Raimi,-44831605,Kevin Costner,9,Michael Shaara,35168395
Columbia Pictures,65000000,Les Mayfield,3518533,Martin Lawrence,9,Michael Berry,68518533
Broadway Pictures,34000000,Bruce McCulloch,-3371019,Molly Shannon,10,Molly Shannon,30628981
Canal+ Droits Audiovisuels,13000000,Andrew Fleming,-6758303,Kirsten Dunst,8,Andrew Fleming,6241697
Walt Disney Pictures,80000000,James Algar,-19344580,James Levine,6,Eric Goldberg,60655420
Screen Gems,31000000,Mark Pellington,-6637499,Jeff Bridges,7,Ehren Kruger,24362501
Mandeville Films,35000000,Garry Marshall,-7202729,Juliette Lewis,2,Alexandra Rose,27797271
Fox 2000 Pictures,92000000,Andy Tennant,-52736580,Jodie Foster,12,Anna Leonowens,39263420
DreamWorks,20000000,Peter Ho-Sun Chan,-11723772,Kate Capshaw,5,Cathleen Schine,8276228
DreamWorks,75000000,Bronwen Hughes,-22111820,Sandra Bullock,3,Marc Lawrence,52888180
40 Acres & A Mule Filmworks,9000000,Malcolm D. Lee,25102780,Taye Diggs,10,Malcolm D. Lee,34102780
David Brown Productions,50000000,Alan Parker,-36961340,Emily Watson,1,Frank McCourt,13038660
Columbia Pictures Corporation,23000000,Neil Jordan,-12339853,Ralph Fiennes,1,Graham Greene,10660147
Warner Bros.,55000000,Clint Eastwood,-38364661,Clint Eastwood,3,Andrew Klavan,16635339
Columbia Pictures Corporation,30000000,Sidney Lumet,-25844766,Sharon Stone,1,John Cassavetes,4155234
Imagine Entertainment,80000000,Ron Howard,-57637500,Matthew McConaughey,3,Émile Gaudreault,22362500
Spyglass Entertainment,80000000,Jon Turteltaub,-45901437,Anthony Hopkins,6,Gerald Di Pego,34098563
Columbia Pictures Corporation,64000000,Sydney Pollack,-32945076,Harrison Ford,10,Warren Adler,31054924
Bona Fide Productions,6000000,Rick Famuyiwa,19047631,Elayn J. Taylor,7,Rick Famuyiwa,25047631
Mutual Film Company,75000000,John Bruno,-60989310,Jamie Lee Curtis,1,Chuck Pfarrer,14010690
Artisan Entertainment,9000000,Steven Soderbergh,-5806898,Terence Stamp,8,Lem Dobbs,3193102
Crystal Sky Worldwide,12000000,Bob Clark,15141959,Kathleen Turner,3,Steven Paul,27141959
Miramax,14000000,Tony Goldwyn,-9258013,Diane Lane,4,Pamela Gray,4741987
Arts Council of England,14000000,Oliver Parker,4535191,Rupert Everett,6,Oscar Wilde,18535191
Castle Rock Entertainment,50000000,Rob Reiner,-22932840,Bruce Willis,10,Alan Zweibel,27067160
Play It Inc.,24000000,Ron Shelton,-15572796,Woody Harrelson,1,Ron Shelton,8427204
3 Miles Apart Productions Ltd.,33000000,Mike Newell,-24593736,John Cusack,4,Darcy Frey,8406264
Columbia Pictures Corporation,38000000,Ulu Grosbard,-24623494,Michelle Pfeiffer,3,Jacquelyn Mitchard,13376506
New Regency Pictures,6000000,Mark Tarlov,-1605064,Sarah Michelle Gellar,2,Judith Roberts,4394936
Sweetland Films,29750000,Woody Allen,-25553379,Sean Penn,3,Woody Allen,4196621
Castle Rock Entertainment,75000000,Kelly Makin,-41135658,Hugh Grant,8,Adam Scheinman,33864342
Craven-Maddalena Films,27000000,Wes Craven,-12140606,Meryl Streep,10,Pamela Gray,14859394
Dogstar Films,6000000,Risa Bramon Garcia,851636,Ben Affleck,2,Shana Larsen,6851636
Fox 2000 Pictures,23000000,Wayne Wang,-4346385,Susan Sarandon,11,Mona Simpson,18653615
Miramax,13000000,Kevin Williamson,-4053763,Helen Mirren,8,Kevin Williamson,8946237
Walt Disney Pictures,65000000,Donald Petrie,-28169943,Christopher Lloyd,2,John L. Greene,36830057
Columbia Pictures,45000000,Peter Kassovitz,-40043599,Robin Williams,9,Jurek Becker,4956401
Toho Pictures,13000000,Takao Okawara,-2962610,Hiroshi Abe,8,Hiroshi Kashiwabara,10037390
Metro-Goldwyn-Mayer (MGM),60000000,Irwin Winkler,-37634867,Val Kilmer,1,Oliver Sacks,22365133
Universal Pictures,35000000,Ang Lee,-34369221,Tobey Maguire,11,Daniel Woodrell,630779
Columbia Pictures Corporation,15000000,Antonio Banderas,-13045798,Melanie Griffith,10,Mark Childress,1954202
Touchstone Pictures,28000000,Lawrence Kasdan,-23445431,Loren Dean,9,Lawrence Kasdan,4554569
Cattleya,12000000,Franco Zeffirelli,2348123,Maggie Smith,5,John Mortimer,14348123
Baumgarten-Prophet Entertainment,45000000,Mic Rodgers,-34568780,Jean-Claude Van Damme,8,Richard Rothstein,10431220
Beacon Communications,3000000,David Raynr,6016377,Deon Richmond,5,Gary Hardwick,9016377
Baumgarten-Prophet Entertainment,4000000,Jeff Franklin,-1200000,French Stewart,9,Jeff Franklin,2800000
Jim Henson Pictures,26000000,Gary Halvorson,-14365542,Kevin Clash,10,Mitchell Kriegman,11634458
New Line Cinema,51000000,Gary Sinyor,-29268999,Chris O'Donnell,11,Roi Cooper Megrue,21731001
4 Kids Entertainment,30000000,Michael Haigney,13758684,Rica Matsumoto,7,Satoshi Tajiri,43758684
Jim Henson Pictures,24000000,Tim Hill,-7374193,Dave Goelz,7,Jerry Juhl,16625807
Miramax,7000000,Michael Corrente,292175,Shawn Hatosy,9,Peter Farrelly,7292175
Ambridge Film Partnership,35000000,Stephan Elliott,-18540996,Ewan McGregor,1,Marc Behm,16459004
New Line Cinema,25000000,James Foley,-9843800,Yun-Fat Chow,3,Robert Pucci,15156200
Elysian Dreams,8500000,Robert Altman,2419177,Glenn Close,4,Anne Rapp,10919177
Universal Pictures,35000000,Scott Hicks,-20621647,Ethan Hawke,1,David Guterson,14378353
Pathé Pictures International,30000,Lynne Ramsay,186781,Tommy Flanagan,11,Lynne Ramsay,216781
Dogstar Films,7000000,Mike Barker,-6974349,Alessandro Nivola,4,Ted Griffin,25651
Good Machine,450000,Jim Fall,1599595,Christian Campbell,7,Jason Schafer,2049595
Newmarket Capital Group,4000000,Mike Figgis,-3600207,Julian Sands,1,Mike Figgis,399793
Warner Bros.,20000000,Damon Santostefano,-9455857,Neve Campbell,10,Rodney Patrick Vaccaro,10544143
Kang Je-Kyu Film Co. Ltd.,5000000,Je-kyu Kang,-4902848,Suk-kyu Han,2,Je-kyu Kang,97152
American Entertainment Investors,30000000,Chris Roberts,-18423913,Freddie Prinze Jr.,3,Chris Roberts,11576087
Amblin Entertainment,30000000,Neil Jordan,-17982631,Annette Bening,1,Bari Wood,12017369
Morgan Creek Productions,25000000,Richard Rich,-13043462,Miranda Richardson,3,Oscar Hammerstein II,11956538
Dimension Films,7000000,Michael Rymer,7003141,Omar Epps,8,Michael Henry Brown,14003141
Flying Heart Films,12000000,Alan Rudolph,-11824630,Bruce Willis,2,Kurt Vonnegut Jr.,175370
Cherry Alley Productions,75000000,Sam Weisman,-46464232,Steve Martin,4,Neil Simon,28535768
Bigel / Mailer Films,12000000,James Toback,-6758685,Ben Stiller,4,James Toback,5241315
Cradle Productions Inc.,32000000,Tim Robbins,-29100030,Hank Azaria,1,Tim Robbins,2899970
Metro-Goldwyn-Mayer (MGM),50000000,Scott Silver,-36739950,Claire Danes,3,Buddy Ruskin,13260050
Evenstar Films,2500000,Alison Maclean,-1217916,Billy Crudup,7,Denis Johnson,1282084
Universal Pictures,70000000,Hugh Wilson,-60305895,Brendan Fraser,8,Jay Ward,9694105
Alcon Entertainment,30000000,Jeff Pollack,-23454640,David Spade,4,J.B. Cook,6545360
Beaver Productions,30000000,Richard Attenborough,-29367383,Pierce Brosnan,10,William Nicholson,632617
Destination Films,5250000,Louis Morneau,4905690,Lou Diamond Phillips,10,John Logan,10155690
Global Entertainment Productions GmbH & Company Medien KG,10000000,Kevin Alyn Elders,-9707848,Dennis Rodman,9,Moshe Diamant,292152
October Films,15000000,Albert Brooks,-3385764,Albert Brooks,8,Albert Brooks,11614236
Santa Monica Holdings,500000,Lloyd Kaufman,-498566,Will Keenan,6,Patrick Cassidy,1434
Morgan Creek Productions,70000000,Hugh Johnson,-58772060,Cuba Gooding Jr.,9,Drew Gitlin,11227940
7 Arts International,14000000,Martha Fiennes,-13793872,Ralph Fiennes,11,Peter Ettedgui,206128
Absolute Entertainment (II),21000000,John Duigan,-20984407,Elisabeth Shue,7,Richard Christie,15593
Marked Entertainment,1700000,Mark Illsley,243649,Jeremy Northam,12,Ed Stone,1943649
Emotion Pictures,10000000,Matthew Warchus,-9097856,Nick Nolte,2,Sam Shepard,902144
Spanky Pictures,312000,Gavin O'Connor,969176,Janet McTeer,3,Angela Shelton,1281176
Code Productions,7500000,Robert Marcarelli,5114346,Casper Van Dien,8,Stephan Blinn,12614346
Artisan Entertainment,4500000,Darren Aronofsky,-890722,Ellen Burstyn,12,Hubert Selby Jr.,3609278
DreamWorks,103000000,Ridley Scott,84705427,Russell Crowe,5,David Franzoni,187705427
Am Psycho Productions,7000000,Mary Harron,8070285,Christian Bale,4,Bret Easton Ellis,15070285
Columbia Pictures Corporation,110000000,Roland Emmerich,3330342,Mel Gibson,6,Robert Rodat,113330342
Newmarket Capital Group,9000000,Christopher Nolan,16544867,Guy Pearce,5,Christopher Nolan,25544867
Jerry Bruckheimer Films,30000000,Boaz Yakin,85654751,Denzel Washington,9,Gregory Allen Howard,115654751
Touchstone Pictures,75000000,M. Night Shyamalan,20011339,Bruce Willis,11,M. Night Shyamalan,95011339
Columbia Pictures,60000000,Cameron Crowe,-27465150,Billy Crudup,9,Cameron Crowe,32534850
Twentieth Century Fox Film Corporation,90000000,Robert Zemeckis,143632142,Tom Hanks,12,William Broyles Jr.,233632142
Twentieth Century Fox Film Corporation,75000000,Bryan Singer,82299717,Patrick Stewart,7,Tom DeSanto,157299717
Columbia Pictures Corporation,95000000,Paul Verhoeven,-21790660,Kevin Bacon,8,Gary Scott Thompson,73209340
Dimension Films,19000000,Keenen Ivory Wayans,138019771,Anna Faris,7,Shawn Wayans,157019771
Figment Films,50000000,Danny Boyle,-10214973,Leonardo DiCaprio,2,John Hodge,39785027
DreamWorks,100000000,Robert Zemeckis,55464351,Harrison Ford,7,Clark Gregg,155464351
New Line Cinema,23000000,James Wong,30331147,Devon Sawa,3,Glen Morgan,53331147
Columbia Pictures Corporation,93000000,McG,32305545,Cameron Diaz,11,Ryan Rowe,125305545
DreamWorks,16000000,Todd Phillips,52540777,Breckin Meyer,5,Todd Phillips,68540777
Touchstone Pictures,26000000,Joel Coen,19506619,George Clooney,2,Homer,45506619
Touchstone Pictures,90000000,Dominic Sena,11648571,Nicolas Cage,6,H.B. Halicki,101648571
New Line Cinema,33000000,Tarsem Singh,28334059,Jennifer Lopez,8,Mark Protosevich,61334059
Asia Union Film & Entertainment Ltd.,17000000,Ang Lee,111078872,Yun-Fat Chow,1,Du Lu Wang,128078872
Universal Pictures,123000000,Ron Howard,137044825,Jim Carrey,11,Dr. Seuss,260044825
Touchstone Pictures,100000000,Brian De Palma,-39116593,Tim Robbins,3,Lowell Cannon,60883407
Paramount Pictures,125000000,John Woo,90409889,Tom Cruise,5,Bruce Geller,215409889
Beacon Communications,11000000,Peyton Reed,57379000,Kirsten Dunst,8,Jessica Bendinger,68379000
Universal Pictures,52000000,Steven Soderbergh,73595205,Julia Roberts,3,Susannah Grant,125595205
Castle Rock Entertainment,45000000,Donald Petrie,61807667,Sandra Bullock,12,Marc Lawrence,106807667
Miramax,25000000,Lasse Hallström,46509363,Juliette Binoche,1,Joanne Harris,71509363
Paramount Pictures,70000000,Nancy Meyers,112811707,Mel Gibson,12,Josh Goldsmith,182811707
Avery Pix,85000000,Steven Brill,-45535225,Adam Sandler,11,Tim Herlihy,39464775
Bedford Falls Company The,48000000,Steven Soderbergh,76115725,Michael Douglas,1,Simon Moore,124115725
Jerry Bruckheimer Films,45000000,David McNally,15786269,Piper Perabo,8,Gina Wendkos,60786269
Walt Disney Feature Animation,100000000,Mark Dindal,-10697313,David Spade,12,Chris Williams,89302687
Warner Bros.,73000000,Roger Christian,-51528315,John Travolta,5,Corey Mandell,21471685
DreamWorks Animation,95000000,Bibo Bergeron,-44136258,Kevin Kline,3,Terry Rossio,50863742
Polygram Filmed Entertainment,23000000,David Twohy,16240659,Radha Mitchell,2,Jim Wheat,39240659
Bel Air Entertainment,50000000,Howard Deutch,-5262941,Keanu Reeves,8,Vince McKewin,44737059
StudioCanal,5000000,Stephen Daldry,16995263,Jamie Bell,11,Lee Hall,21995263
Altavista Films,2000000,Alejandro González Iñárritu,3383834,Emilio Echevarría,4,Guillermo Arriaga,5383834
Touchstone Pictures,30000000,Stephen Frears,-2722945,John Cusack,3,Nick Hornby,27277055
Twentieth Century Fox Film Corporation,51000000,Bobby Farrelly,39570999,Jim Carrey,6,Peter Farrelly,90570999
Castle Rock Entertainment,6000000,Christopher Guest,12621249,Fred Willard,10,Christopher Guest,18621249
Zentropa Entertainments,12800000,Lars von Trier,-8615964,Björk,10,Lars von Trier,4184036
Walt Disney Pictures,127500000,Eric Leighton,10248063,D.B. Sweeney,5,Thom Enriquez,137748063
Twentieth Century Fox Film Corporation,48000000,Harold Ramis,-10120004,Brendan Fraser,10,Peter Cook,37879996
Universal Pictures,55000000,Jay Roach,111244045,Ben Stiller,10,Greg Glienna,166244045
Dimension Films,40000000,Wes Craven,49138076,David Arquette,2,Kevin Williamson,89138076
New Line Cinema,31000000,Gregory Hoblit,14010278,Dennis Quaid,4,Toby Emmerich,45010278
Aardman Animations,45000000,Peter Lord,61834564,Mel Gibson,6,Peter Lord,106834564
Fox 2000 Pictures,32000000,George Tillman Jr.,16818921,Cuba Gooding Jr.,11,Scott Marshall Smith,48818921
Warner Bros.,140000000,Wolfgang Petersen,42618434,George Clooney,6,Sebastian Junger,182618434
Paramount Pictures,46000000,John Singleton,24334258,Samuel L. Jackson,6,Ernest Tidyman,70334258
Franchise Pictures,41300000,Jonathan Lynn,15962492,Bruce Willis,2,Mitchell Kapner,57262492
New Line Cinema,80000000,Roger Donaldson,-45407911,Kevin Costner,1,David Self,34592089
Warner Bros.,40000000,Mimi Leder,-6480372,Kevin Spacey,10,Catherine Ryan Hyde,33519628
Fox Searchlight Pictures,13500000,Philip Kaufman,-6439124,Geoffrey Rush,12,Doug Wright,7060876
Twentieth Century Fox Film Corporation,13000000,Danny Leiner,33729800,Ashton Kutcher,12,Philip Stark,46729800
Twentieth Century Fox Film Corporation,15000000,Matt Williams,18771174,Natalie Portman,4,Lowell Ganz,33771174
New Line Cinema,7000000,Ben Younger,9938179,Giovanni Ribisi,2,Ben Younger,16938179
Universal Pictures,83000000,Brian Levant,-47731725,Mark Addy,4,William Hanna,35268275
Universal Pictures,84000000,Peter Segal,39309890,Eddie Murphy,7,Jerry Lewis,123309890
Columbia Pictures Corporation,29000000,Nicholas Hytner,-11825130,Amanda Schull,5,Carol Heikkinen,17174870
New Line Cinema,11000000,Steve Carr,46328603,Ice Cube,1,Ice Cube,57328603
Lakeshore Entertainment,10000000,Sam Raimi,2008642,Cate Blanchett,1,Billy Bob Thornton,12008642
Universal Pictures,60000000,Brett Ratner,15793305,Nicolas Cage,12,David Diamond,75793305
Copperheart Entertainment,5000000,John Fawcett,-4997446,Emily Perkins,5,Karen Walton,2554
Twentieth Century Fox Film Corporation,80000000,Robert Redford,-49304773,Will Smith,11,Steven Pressfield,30695227
Universal Pictures,62000000,Jonathan Mostow,15086030,Matthew McConaughey,4,Jonathan Mostow,77086030
Spyglass Entertainment,29000000,Edward Norton,8047880,Ben Stiller,4,Stuart Blumberg,37047880
Touchstone Pictures,55000000,Tom Dey,1937502,Jackie Chan,5,Miles Millar,56937502
Columbia Pictures Corporation,57000000,Billy Bob Thornton,-41472875,Matt Damon,12,Cormac McCarthy,15527125
Twentieth Century Fox Film Corporation,30000000,Raja Gosnell,87559438,Martin Lawrence,6,Darryl Quarles,117559438
Clipsal Films,65000000,Clint Eastwood,25464773,Clint Eastwood,8,Ken Kaufman,90464773
Phoenix Pictures,82000000,Roger Spottiswoode,-47395720,Arnold Schwarzenegger,11,Cormac Wibberley,34604280
Columbia Pictures Corporation,43000000,Betty Thomas,-5829512,Sandra Bullock,4,Susannah Grant,37170488
Columbia Pictures Corporation,75000000,Martin Campbell,-5756141,Scott Glenn,12,Robert King,69243859
George Litto Productions,38000000,Michael Dinner,-24980747,Richard Dreyfuss,8,Barry Fanaro,13019253
40 Acres & A Mule Filmworks,20000000,Gina Prince-Bythewood,7441122,Sanaa Lathan,4,Gina Prince-Bythewood,27441122
Warner Bros.,25000000,Andrzej Bartkowiak,30973336,Jet Li,3,Mitchell Kapner,55973336
Hart-Sharp Entertainment,1200000,Kenneth Lonergan,7980275,Laura Linney,12,Kenneth Lonergan,9180275
Dimension Films,54000000,Patrick Lussier,-20977233,Gerard Butler,12,Joel Soisson,33022767
Metro-Goldwyn-Mayer (MGM),65000000,Joan Chen,-27247069,Richard Gere,8,Allison Burnett,37752931
Columbia Pictures Corporation,43000000,Gus Van Sant,8804714,Sean Connery,1,Mike Rich,51804714
David Kirschner Productions,75000000,Don Bluth,-52248021,Matt Damon,6,Hans Bauer,22751979
Saturn Films,8000000,E. Elias Merhige,279017,John Malkovich,1,Steven Katz,8279017
Columbia Pictures Corporation,32000000,David Raynr,-23264471,Shane West,3,Mark Schwahn,8735529
New Line Cinema,45000000,Courtney Solomon,-29779315,Justin Whalin,12,Topper Lilien,15220685
Capella International,76000000,Des McAnuff,-49999390,Robert De Niro,6,Jay Ward,26000610
Paramount Pictures,60000000,William Friedkin,1335230,Tommy Lee Jones,4,Jim Webb,61335230
Dimension Films,42000000,John Frankenheimer,-18639221,Ben Affleck,2,Ehren Kruger,23360779
Warner Bros.,80000000,Antony Hoffman,-62519110,Val Kilmer,11,Chuck Pfarrer,17480890
Cruella Productions,85000000,Kevin Lima,-18042974,Glenn Close,11,Dodie Smith,66957026
Avrora Media,35000000,Uli Edel,-21444012,Jonathan Lipnicki,10,Angela Sommer-Bodenburg,13555988
Haft Entertainment,10000000,Joel Schumacher,-9860308,Colin Farrell,5,Ross Klavan,139692
Branti Film Productions,20000000,Amy Heckerling,-4381374,Jason Biggs,7,Amy Heckerling,15618626
Hammerhead Productions,90000000,Walter Hill,-75781132,James Spader,1,William Malone,14218868
Revelations Entertainment,25000000,Stephen Hopkins,-24741309,Morgan Freeman,8,John Wainwright,258691
British Broadcasting Corporation (BBC),55000000,Curtis Hanson,-35610546,Michael Douglas,2,Michael Chabon,19389454
Chester Films Inc.,65000000,Jon Turteltaub,4691949,Bruce Willis,7,Audrey Wells,69691949
Morgan Creek Productions,63600000,Stephen Kay,-48632818,Sylvester Stallone,10,Ted Lewis,14967182
Metro-Goldwyn-Mayer (MGM),24000000,Bonnie Hunt,8662299,David Duchovny,4,Bonnie Hunt,32662299
FX Sound,1500000,Fabián Bielinsky,-278739,Ricardo Darín,8,Fabián Bielinsky,1221261
Artisan Entertainment,15000000,Joe Berlinger,11437094,Jeffrey Donovan,10,Daniel Myrick,26437094
Miramax,24000000,James Gray,-23117290,Mark Wahlberg,10,James Gray,882710
Castle Rock Entertainment,65000000,Taylor Hackford,-32401069,Meg Ryan,12,Tony Gilroy,32598931
Bel Air Entertainment,24000000,Brian Robbins,-11627590,David Arquette,4,Steven Brill,12372410
Lewitt / Eberts Prouctions,30000000,Joe Charbanic,-1072280,James Spader,9,Darcy Meyers,28927720
Universal Pictures,35000000,Rob Cohen,7180,Joshua Jackson,3,John Pogue,35007180
Brant-Allen,6000000,Ed Harris,2596914,Ed Harris,3,Steven Naifeh,8596914
Portman Entertainment Group,10000000,Nigel Cole,2115757,Brenda Blethyn,9,Mark Crowdy,12115757
Destination Films,14000000,Sally Field,-10939037,Minnie Driver,9,Jon Bernstein,3060963
Artisan Entertainment,8500000,Christopher McQuarrie,-2444339,Ryan Phillippe,9,Christopher McQuarrie,6055661
Alcon Entertainment,6000000,Jay Russell,28099640,Frankie Muniz,3,Willie Morris,34099640
Artisan Entertainment,23000000,Robert Altman,-9886959,Richard Gere,10,Anne Rapp,13113041
Gullane Pictures,19000000,Britt Allcroft,-3088667,Alec Baldwin,7,Britt Allcroft,15911333
Columbia Pictures Corporation,60000000,Diane Keaton,-23949770,Diane Keaton,2,Delia Ephron,36050230
Punch 21 Productions,35000000,Robert Iscove,-14372628,Freddie Prinze Jr.,6,Andrew Lowery,20627372
Davis-Panzer Productions,25000000,Douglas Aarniokoski,-12198810,Christopher Lambert,9,Gregory Widen,12801190
Open City Films,35000000,Kris Isacsson,-14964690,Freddie Prinze Jr.,1,Kris Isacsson,20035310
StudioCanal,16000000,Kathryn Bigelow,-15897378,Catherine McCormack,7,Anita Shreve,102622
Broadway Pictures,24000000,Reginald Hudlin,-10407128,Tim Meadows,10,Tim Meadows,13592872
DreamWorks,25000000,Woody Allen,-7928770,Woody Allen,5,Woody Allen,17071230
Cinerenta Medienbeteiligungs KG,20000000,Rod Lurie,-2127277,Joan Allen,10,Rod Lurie,17872723
Morgan Creek Productions,60000000,Christian Duguay,-29791401,Wesley Snipes,8,Wayne Beach,30208599
New Line Cinema,10000000,Spike Lee,-7814734,Damon Wayans,10,Spike Lee,2185266
MFF Feature Film Productions,13000000,Chris Koch,47020107,Chevy Chase,2,Will McRobb,60020107
Paramount Pictures,30000000,Stig Bergqvist,46507756,Christine Cavanaugh,11,J. David Stem,76507756
Phoenix Pictures,14000000,John Ottman,7468807,Jennifer Morrison,9,Silvio Horta,21468807
Miramax,35000000,Don Roos,1779296,Ben Affleck,11,Don Roos,36779296
NPV Entertainment,24000000,Davis Guggenheim,-18891180,James Marsden,4,Gregory Poirier,5108820
Paramount Pictures,65000000,Chuck Russell,-35625822,Kim Basinger,8,Cathy Cash Spellman,29374178
double A Films,2000000,Michael Almereyda,-431251,Ethan Hawke,6,William Shakespeare,1568749
Green/Renzi,1000000,Karyn Kusama,523941,Michelle Rodriguez,10,Karyn Kusama,1523941
Hollywood Pictures,10000000,Eric Blakeney,-8368161,Liam Neeson,2,Eric Blakeney,1631839
Avery Pix,50000000,Janusz Kaminski,-33220364,Winona Ryder,10,Pierce Gardner,16779636
Artic Productions LLC,10000000,John Waters,-8715354,Melanie Griffith,9,John Waters,1284646
ErgoArts,1800000,Maggie Greenwald,1250934,Janet McTeer,7,Maggie Greenwald,3050934
Fox Searchlight Pictures,8000000,Fina Torres,-2981550,Penélope Cruz,9,Vera Blasi,5018450
Recorded Picture Company (RPC),10000000,Takeshi Kitano,-9552250,Takeshi Kitano,9,Takeshi Kitano,447750
Paramount Pictures,63000000,Nora Ephron,-52985766,John Travolta,10,Adam Resnick,10014234
Hollywood Pictures,15000000,Bruce Paltrow,-10265765,Huey Lewis,9,John Byrum,4734235
Animal Productions LLC,3600000,Steve Buscemi,-3556195,Willem Dafoe,8,Edward Bunker,43805
New Oz Productions,1500000,Robert Lee King,-1234893,Lauren Ambrose,9,Charles Busch,265107
Free Country U.S.A.,42000,David Gordon Green,199816,Candace Evanofski,9,David Gordon Green,241816
Miramax,150000,Gary Winick,2732062,Sigourney Weaver,8,Heather McGowan,2882062
Morgan Creek Productions,12500000,Mary Lambert,-7282502,Lori Heuring,7,Mark Gibson,5217498
Banner Entertainment,1000000,Greg Berlanti,744858,Timothy Olyphant,10,Greg Berlanti,1744858
Code Entertainment,6000000,Nick Gomez,9427192,Danny DeVito,3,Peter Steinfeld,15427192
Pathé Pictures International,13000000,Kenneth Branagh,-12715709,Alessandro Nivola,3,William Shakespeare,284291
Gramercy Pictures (I),24000000,Neil LaBute,1167270,Renée Zellweger,9,John C. Richards,25167270
Icon Entertainment International,8000000,Wim Wenders,-7947474,Jeremy Davies,2,Bono,52526
Disney Television Animation,30000000,Jun Falkenstein,15554533,Jim Cummings,2,A.A. Milne,45554533
Polygram Filmed Entertainment,8500000,Keith Gordon,-8172582,Billy Crudup,3,Scott Spencer,327418
Three Rivers Production,10000000,Terence Davies,-6958197,Gillian Anderson,3,Edith Wharton,3041803
Chango Productions,120000,Bryan Johnson,-105096,Brian O'Halloran,4,Bryan Johnson,14904
Universal Pictures,10000000,Scott Alexander,-2972655,Norm MacDonald,5,Scott Alexander,7027345
4 Kids Entertainment,16000000,Kunihiko Yuyama,1052128,Rica Matsumoto,4,Norman J. Grossfeld,17052128
Columbia Pictures Corporation,50000000,Hugh Hudson,-43456806,Kim Basinger,5,Kuki Gallmann,6543194
Miramax,3000000,Lisa Krueger,-2959639,Heather Graham,7,Lisa Krueger,40361
Castle Rock Entertainment,51000000,Antoine Fuqua,-35674873,Jamie Foxx,9,Andrew Scheinman,15325127
Fox 2000 Pictures,15000000,Mark Piznarski,-4505853,Chris Klein,3,Michael Seitzman,10494147
Screen Gems,4000000,Mike Figgis,-3054959,Jeanne Tripplehorn,4,Mike Figgis,945041
Artisan Entertainment,250000,Miguel Arteta,800600,Mike White,8,Mike White,1050600
Myung Film Company Ltd.,1000000,Ki-duk Kim,-978925,Jung Suh,4,Ki-duk Kim,21075
Lakeshore Entertainment,25000000,John Schlesinger,-10009418,Madonna,3,Tom Ropelewski,14990582
Légende Films,36000000,Roland Joffé,-35950536,Gérard Depardieu,11,Jeanne Labrune,49464
Brillstein-Grey Entertainment,1000000,Craig Mazin,-987004,Rob Lowe,9,James Gunn,12996
Brillstein-Grey Entertainment,60000000,Mike Nichols,-53708398,Garry Shandling,3,Garry Shandling,6291602
Artisan Entertainment,1000000,Henry Bromell,-220863,William H. Macy,10,Henry Bromell,779137
Keystone Family Pictures,4500000,Robert Vince,-3253763,Bernie,10,Anne Vince,1246237
Culture Company The,1000000,Khalid Mohamed,-376209,Jaya Bhaduri,9,Khalid Mohamed,623791
Gramercy Pictures (I),28000000,Marek Kanievska,-22341060,Paul Newman,4,E. Max Frye,5658940
Saban Entertainment,5000000,Mamoru Hosoda,4628751,Lara Jill Miller,10,Akiyoshi Hongo,9628751
Warner Bros.,125000000,Chris Columbus,192575550,Daniel Radcliffe,11,J.K. Rowling,317575550
New Line Cinema,93000000,Peter Jackson,222544750,Elijah Wood,12,J.R.R. Tolkien,315544750
United Artists,10000000,Victor Salva,27904175,Gina Philips,8,Victor Salva,37904175
Les Films Alain Sarde,15000000,David Lynch,-7779757,Naomi Watts,10,David Lynch,7220243
Pandora Cinema,4500000,Richard Kelly,-4305780,Jake Gyllenhaal,10,Richard Kelly,194220
Tokuma Shoten,19000000,Hayao Miyazaki,-8944141,Daveigh Chase,3,Hayao Miyazaki,10055859
Paramount Pictures,115000000,Simon West,16144183,Angelina Jolie,6,Sara B. Cooper,131144183
Universal Pictures,58000000,Ron Howard,112742341,Russell Crowe,1,Akiva Goldsman,170742341
Pixar Animation Studios,115000000,Pete Docter,174916256,Billy Crystal,11,Pete Docter,289916256
Warner Bros.,45000000,Antoine Fuqua,31631907,Denzel Washington,10,David Ayer,76631907
Metro-Goldwyn-Mayer (MGM),18000000,Robert Luketic,78520674,Reese Witherspoon,7,Amanda Brown,96520674
Revolution Studios,92000000,Ridley Scott,16638745,Josh Hartnett,1,Mark Bowden,108638745
Universal Pictures,38000000,Rob Cohen,106533925,Vin Diesel,6,Ken Li,144533925
DreamWorks Animation,60000000,Andrew Adamson,207665011,Mike Myers,5,William Steig,267665011
Metro-Goldwyn-Mayer (MGM),87000000,Ridley Scott,78092268,Anthony Hopkins,2,Thomas Harris,165092268
Apostle,53000000,Ted Demme,-9225,Johnny Depp,4,Bruce Porter,52990775
Eureka Pictures,5000000,David Wain,-4707898,Janeane Garofalo,4,Michael Showalter,292102
Twentieth Century Fox Film Corporation,100000000,Tim Burton,80011740,Mark Wahlberg,7,Pierre Boulle,180011740
Fox Searchlight Pictures,1200000,Jay Chandrasekhar,17288314,Jay Chandrasekhar,2,Jay Chandrasekhar,18488314
Warner Bros.,85000000,Steven Soderbergh,98405771,George Clooney,12,George Clayton Johnson,183405771
Touchstone Pictures,140000000,Michael Bay,58542554,Ben Affleck,5,Randall Wallace,198542554
Cruise/Wagner Productions,17000000,Alejandro Amenábar,79522687,Nicole Kidman,8,Alejandro Amenábar,96522687
Touchstone Pictures,21000000,Wes Anderson,31364010,Gene Hackman,1,Wes Anderson,52364010
Twentieth Century Fox Film Corporation,50000000,Baz Luhrmann,7386607,Nicole Kidman,6,Baz Luhrmann,57386607
Warner Bros.,57000000,Stephen Herek,-39991718,Mark Wahlberg,9,John Stockwell,17008282
Warner Bros.,100000000,Steven Spielberg,-21383311,Haley Joel Osment,6,Brian Aldiss,78616689
Anhelo Producciones,2000000,Alfonso Cuarón,11622333,Maribel Verdú,4,Alfonso Cuarón,13622333
Walt Disney Pictures,26000000,Garry Marshall,82248956,Julie Andrews,8,Meg Cabot,108248956
Dimension Films,35000000,Robert Rodriguez,77719001,Alexa PenaVega,3,Robert Rodriguez,112719001
Columbia Pictures Corporation,15000000,Joel Gallen,23252284,Chyler Leigh,12,Mike Bender,38252284
Universal Pictures,98000000,Stephen Sommers,104019785,Brendan Fraser,5,Stephen Sommers,202019785
Paramount Pictures,68000000,Cameron Crowe,32614858,Tom Cruise,12,Alejandro Amenábar,100614858
Columbia Pictures Corporation,65000000,Brian Helgeland,-8430298,Heath Ledger,5,Brian Helgeland,56569702
Walt Disney Feature Animation,120000000,Gary Trousdale,-35947238,Michael J. Fox,6,Tab Murphy,84052762
Dimension Films,45000000,Keenen Ivory Wayans,26308997,Anna Faris,7,Shawn Wayans,71308997
Twentieth Century Fox Film Corporation,35000000,Albert Hughes,-3397434,Johnny Depp,10,Alan Moore,31602566
Miramax,25000000,Sharon Maguire,46543427,Renée Zellweger,4,Helen Fielding,71543427
Warner Bros.,42000000,Steve Beck,-132040,Tony Shalhoub,10,Robb White,41867960
Metro-Goldwyn-Mayer (MGM),42000000,Michael Cristofer,-25747235,Antonio Banderas,8,Cornell Woolrich,16252765
LivePlanet,30000000,J.B. Rogers,115103595,Jason Biggs,8,Adam Herz,145103595
Swanford Films,68000000,Jean-Jacques Annaud,-16598242,Jude Law,3,Jean-Jacques Annaud,51401758
Paramount Pictures,28000000,Ben Stiller,17172250,Ben Stiller,9,Drake Sather,45172250
New Line Cinema,22000000,Jessie Nelson,18311852,Sean Penn,1,Kristine Johnson,40311852
Miramax,28000000,Peter Chelsom,22294317,John Cusack,10,Marc Klein,50294317
Universal Pictures,93000000,Joe Johnston,88171875,Sam Neill,7,Michael Crichton,181171875
Columbia Pictures Corporation,107000000,Michael Mann,-48796895,Will Smith,12,Gregory Allen Howard,58203105
Lee Daniels Entertainment,4000000,Marc Forster,27252964,Billy Bob Thornton,3,Milo Addica,31252964
Dimension Films,22000000,Kevin Smith,8059386,Jason Mewes,8,Kevin Smith,30059386
United Artists,7000000,Terry Zwigoff,-782151,Steve Buscemi,9,Daniel Clowes,6217849
Paramount Pictures,48000000,Jerry Zucker,8618055,Breckin Meyer,8,Andy Breckman,56618055
Universal Pictures,39000000,Harry Elfont,-24747170,Rachael Leigh Cook,4,Deborah Kaplan,14252830
IMF Internationale Medien und Film GmbH & Co. 2. Produktions KG,68000000,Iain Softley,-17661515,Kevin Spacey,10,Gene Brewer,50338485
Twentieth Century Fox Film Corporation,40000000,Bobby Farrelly,30836296,Jack Black,11,Sean Moynihan,70836296
Paramount Pictures,68000000,Frank Oz,3069884,Robert De Niro,7,Daniel E. Taylor,71069884
Jersey Films,20000000,Jesse Dylan,11155435,Method Man,12,Dustin Lee Abraham,31155435
New Line Cinema,11000000,James Isaac,2121555,Kane Hodder,4,Victor Miller,13121555
Jonathan Krane Group,102000000,Dominic Sena,-32227031,John Travolta,6,Skip Woods,69772969
Morgan Creek Productions,35000000,Sean Penn,-15280070,Jack Nicholson,1,Friedrich Dürrenmatt,19719930
USA Films,1500000,Brad Anderson,-1121824,David Caruso,9,Brad Anderson,378176
New Line Cinema,90000000,Brett Ratner,136164286,Jackie Chan,8,Ross LaManna,226164286
David Kirschner Productions,11000000,Bill Paxton,2103828,Bill Paxton,4,Brent Hanley,13103828
Columbia Pictures Corporation,17700000,Dennie Gordon,9387695,David Spade,4,David Spade,27087695
DreamWorks,57000000,Gore Verbinski,9808615,Brad Pitt,3,J.H. Wyman,66808615
Deseo El,4500000,Guillermo del Toro,-3745251,Marisa Paredes,10,Guillermo del Toro,754749
Regency Enterprises,23000000,John Dahl,-1026818,Steve Zahn,10,Clay Tarver,21973182
Paramount Pictures,60000000,Lee Tamahori,14078174,Morgan Freeman,4,James Patterson,74078174
Good Machine,20000000,Joel Coen,-12505151,Billy Bob Thornton,11,Joel Coen,7494849
Cort/Madden Productions,13000000,Thomas Carter,78057006,Julia Stiles,1,Duane Adler,91057006
Twentieth Century Fox Film Corporation,40000000,John Moore,19068786,Gene Hackman,11,Jim Thomas,59068786
USA Films,19800000,Robert Altman,21508615,Maggie Smith,1,Julian Fellowes,41308615
Bandeira Entertainment,13000000,Blair Hayes,-7997690,Jake Gyllenhaal,8,Cinco Paul,5002310
Columbia Pictures Corporation,80000000,Ivan Reitman,-41654506,David Duchovny,6,Don Jakoby,38345494
Universal Pictures,115000000,Tony Scott,-114973129,Robert Redford,11,Michael Frost Beckner,26871
Columbia Pictures,16000000,John Singleton,12734552,AlexSandra Wright,6,John Singleton,28734552
Konrad Pictures,48000000,James Mangold,-878141,Meg Ryan,12,Steven Rogers,47121859
Davis Entertainment,35000000,David Mirkin,5334024,Sigourney Weaver,3,Robert Dunn,40334024
Screen Gems,28000000,John Carpenter,-19565399,Natasha Henstridge,8,Larry Sulkis,8434601
Regency Enterprises,50000000,Gary Fleder,5001642,Michael Douglas,9,Andrew Klavan,55001642
Warner Bros.,70000000,Bobby Farrelly,-56403089,Laurence Fishburne,8,Marc Hyman,13596911
Bungalow Productions,21150000,Simon Wincer,4485682,Paul Hogan,4,Paul Hogan,25635682
Fuller Films,1500000,Henry Bean,-1093965,Ryan Gosling,8,Henry Bean,406035
Warner Bros.,40000000,Pat O'Connor,-14711897,Keanu Reeves,2,Herman Raucher,25288103
Metro-Goldwyn-Mayer (MGM),75000000,Barry Levinson,-33424859,Bruce Willis,10,Harley Peyton,41575141
DreamWorks,72000000,Rod Lurie,-53791922,Robert Redford,10,David Scarpa,18208078
Warner Bros.,10000000,Jamie Blanks,10384136,Denise Richards,2,Tom Savage,20384136
Columbia Pictures Corporation,35000000,Adam Shankman,25400856,Jennifer Lopez,1,Pamela Falk,60400856
Aamir Khan Productions,6000000,Ashutosh Gowariker,-5929853,Aamir Khan,5,Ashutosh Gowariker,70147
Star Overseas,10000000,Stephen Chow,-9511128,Stephen Chow,7,Stephen Chow,488872
New Line Cinema,60000000,John Herzfeld,-35596448,Robert De Niro,3,John Herzfeld,24403552
Castle Rock Entertainment,31000000,Scott Hicks,-6814219,Anthony Hopkins,9,Stephen King,24185781
Paramount Pictures,7000000,Louis C.K.,-3706742,Chris Rock,6,Louis C.K.,3293258
Castle Rock Entertainment,72000000,Frank Darabont,-44192734,Jim Carrey,12,Michael Sloane,27807266
Winkler Films,27000000,Irwin Winkler,-11347363,Hayden Christensen,11,Mark Andrus,15652637
Twentieth Century Fox Film Corporation,25000000,Chris Nahon,11845124,Jet Li,7,Jet Li,36845124
Fox 2000 Pictures,23000000,Tony Goldwyn,4338033,Ashley Judd,3,Laura Zigman,27338033
Revolution Studios,46000000,Joe Roth,47607673,Julia Roberts,7,Billy Crystal,93607673
Columbia Pictures,48000000,Penny Marshall,-17834464,Drew Barrymore,10,Beverly D'Onofrio,30165536
Paramount Pictures,30000000,John A. Davis,50936232,Debi Derryberry,12,John A. Davis,80936232
Morgan Creek Productions,39000000,David Mamet,-38952761,Gene Hackman,11,David Mamet,47239
Touchstone Pictures,24000000,Brendan Malloy,-10096738,Flex Alexander,11,Jon Zack,13903262
Warner Bros.,60000000,Lawrence Guterman,33385515,Alec Baldwin,7,John Requa,93385515
Columbia Pictures Corporation,30000000,Daniel Sackheim,-11998768,Diane Lane,9,Wesley Strick,18001232
Revolution Studios,49000000,James Wong,-5094254,Jet Li,11,Glen Morgan,43905746
Chickie the Cop,5000000,Tim Blake Nelson,11017403,Mekhi Phifer,8,William Shakespeare,16017403
Miramax,22000000,Tommy O'Haver,-10439741,Kirsten Dunst,3,R. Lee Fleming Jr.,11560259
Chris Lee Productions,137000000,Hironobu Sakaguchi,-104868170,Alec Baldwin,7,Hironobu Sakaguchi,32131830
Columbia Pictures Corporation,22000000,Dennis Dugan,-2648431,Jason Biggs,2,Hank Nelken,19351569
Good Machine,1700000,Todd Field,34230604,Tom Wilkinson,2,Robert Festinger,35930604
Alliance Atlantis Communications,28000000,Ronny Yu,-22795993,Samuel L. Jackson,10,Stel Pavlou,5204007
Warner Bros.,34000000,Michael Tollin,-14306109,Freddie Prinze Jr.,8,Kevin Falls,19693891
Regency Enterprises,14000000,Tom Green,249005,Tom Green,4,Tom Green,14249005
New Line Cinema,11000000,Francine McDougall,2276953,Marla Sokoloff,1,Mandy Nelson,13276953
Twentieth Century Fox Film Corporation,75000000,Henry Selick,-69588001,Brendan Fraser,2,Kaja Blackley,5411999
Paramount Pictures,32000000,Brian Robbins,8219708,Keanu Reeves,9,Daniel Coyle,40219708
Columbia Pictures Corporation,18000000,John Boorman,-4270258,Pierce Brosnan,3,John le Carré,13729742
Paramount Pictures,75000000,Harold Becker,-29792888,John Travolta,11,Lewis Colick,45207112
Franchise Pictures,94000000,Renny Harlin,-61383131,Sylvester Stallone,4,Jan Skrentny,32616869
Universal Pictures,57000000,John Madden,-31456105,Nicolas Cage,8,Shawn Slovo,25543895
Killer Films,6000000,John Cameron Mitchell,-2970919,John Cameron Mitchell,8,John Cameron Mitchell,3029081
FilmFour,15000000,Gregor Jordan,-14646257,Joaquin Phoenix,10,Robert O'Connor,353743
Revolution Studios,47000000,Luke Greenfield,10743062,Rob Schneider,6,Tom Brady,57743062
Universal Pictures,14000000,Mark Waters,-3602635,Monica Potter,2,John J. Strauss,10397365
Twentieth Century Fox Film Corporation,50000000,Gil Junger,-16577194,Martin Lawrence,11,Darryl Quarles,33422806
Touchstone Pictures,13000000,John Stockwell,3929123,Kirsten Dunst,6,Phil Hay,16929123
Franchise Pictures,62000000,Demian Lichtenstein,-46261368,Kurt Russell,2,Richard Recco,15738632
British Broadcasting Corporation (BBC),5500000,Richard Eyre,-4207881,Judi Dench,3,John Bayley,1292119
Warner Bros.,50000000,Andrzej Bartkowiak,1758599,Steven Seagal,3,Ed Horowitz,51758599
October Films,18000000,Harald Zwart,-11709327,Liv Tyler,4,Stan Seidel,6290673
Miramax,35000000,Lasse Hallström,-23565784,Kevin Spacey,1,Annie Proulx,11434216
Metro-Goldwyn-Mayer (MGM),30000000,Peter Howitt,-19034791,Ryan Phillippe,1,Howard Franklin,10965209
Franchise Pictures,53000000,Luis Mandoki,-28955468,Jennifer Lopez,5,Gerald Di Pego,24044532
Walt Disney Pictures,25000000,Tim Hill,-7707619,Alex D. Linz,10,David L. Watts,17292381
3 Arts Entertainment,49000000,Chris Weitz,15186502,Chris Rock,2,Elaine May,64186502
Alter Ego Entertainment,700000,Michael Cuesta,441829,Brian Cox,11,Stephen M. Ryder,1141829
New Line Cinema,90000000,Peter Chelsom,-83280027,Warren Beatty,4,Michael Laughlin,6719973
Morgan Creek Productions,35000000,Les Mayfield,-21735014,Colin Farrell,8,Roderick Taylor,13264986
Dimension Films,40000000,Gary Fleder,-33885763,Shane Brolly,1,Philip K. Dick,6114237
Metro-Goldwyn-Mayer (MGM),60000000,Sam Weisman,-27904682,Martin Lawrence,6,Donald E. Westlake,32095318
Greisman Productions,38000000,Steve Miner,-37376626,James Van Der Beek,11,George Durham,623374
Revolution Studios,11000000,Gregory Poirier,2558739,Shannon Elizabeth,3,Gregory Poirier,13558739
FilmFour,13000000,Jez Butterworth,-8080104,Nicole Kidman,2,Tom Butterworth,4919896
DreamWorks,33000000,Woody Allen,-25503478,Greg Stebner,8,Woody Allen,7496522
Fox Searchlight Pictures,1000000,Charles Herman-Wurmfeld,6022940,Jennifer Westfeldt,4,Heather Juergensen,7022940
Twentieth Century Fox Film Corporation,70000000,Steve Carr,42952899,Eddie Murphy,6,Hugh Lofting,112952899
Detour Filmproduction,100000,Richard Linklater,390475,Ethan Hawke,7,Stephen Belber,490475
Artisan Entertainment,5000000,Jon Favreau,308707,Vince Vaughn,8,Jon Favreau,5308707
Gaumont,35000000,Jean-Marie Poiré,-30222993,Jean Reno,4,Jean-Marie Poiré,4777007
Twentieth Century Fox Film Corporation,22000000,Vondie Curtis-Hall,-17726628,Mariah Carey,9,Cheryl L. West,4273372
MDP Worldwide,40000000,Peter Hyams,-12946185,Justin Chambers,9,Alexandre Dumas,27053815
Blow Up Pictures,250000,Nicole Holofcener,3936931,Catherine Keener,8,Nicole Holofcener,4186931
Stonelock Pictures,4500000,Jill Sprecher,-1211836,Alan Arkin,7,Karen Sprecher,3288164
Goatsingers The,5000000,Tim Blake Nelson,-4482128,David Arquette,11,Miklos Nyiszli,517872
3Mark Entertainment,7000000,Mitch Davis,-2279629,Christopher Gorham,4,Mitch Davis,4720371
Twentieth Century Fox Film Corporation,25000000,J.B. Rogers,-19483292,Chris Klein,3,Peter Gaulke,5516708
New Line Cinema,16000000,Ernest R. Dickerson,-8692244,Snoop Dogg,10,Adam Simon,7307756
Warner Bros.,35000000,John Whitesell,-1642524,David Arquette,3,George Gallo,33357476
Screen Gems,6000000,Gary Hardwick,21457409,Morris Chestnut,3,Gary Hardwick,27457409
Lions Gate Films,7000000,DJ Pooh,3097096,Dr. Dre,11,DJ Pooh,10097096
i5 Films,3000000,Scott McGehee,5821782,Tilda Swinton,8,Elisabeth Sanxay Holding,8821782
Ecosse Films,20000000,Gillian Armstrong,-19331860,Cate Blanchett,1,Sebastian Faulks,668140
Screen Gems,15000000,J.S. Cardone,-7711549,Kerr Smith,4,J.S. Cardone,7288451
Touchstone Pictures,11000000,Rob Pritts,12978402,Chris Kattan,10,David Garrett,23978402
Alcon Entertainment,30000000,Charles Shyer,-29569687,Hilary Swank,12,John Sweet,430313
Disney Television Animation,23000000,Chuck Sheetz,13696761,Andrew Lawrence,2,Paul Germain,36696761
Alma UK Limited,12000000,Bruce Beresford,-11580586,Sarah Wynter,1,Marilyn Levy,419414
Fox 2000 Pictures,38000000,John Pasquin,-15229136,Tim Allen,12,John Scott Shepherd,22770864
Lions Gate Films,7000000,Peter Bogdanovich,-3790519,Kirsten Dunst,5,Steven Peros,3209481
Lost Soul Productions,17000000,Stephen Carpenter,-13899350,Melissa Sagemiller,9,Stephen Carpenter,3100650
United Artists,7000000,Roman Coppola,-6588966,Jeremy Davies,5,Roman Coppola,411034
Screen Gems,13000000,Mark Brown,9235901,Vivica A. Fox,9,Mark Brown,22235901
Bates Entertainment,7000000,Doug McHenry,16247539,LL Cool J,4,David Dean Bottrell,23247539
Universal Pictures,13500000,Kasi Lemmons,-12812806,Samuel L. Jackson,9,George Dawes Green,687194
A Happy Place,10000000,Eric Bross,-5643257,Lance Bass,10,Eric Aronson,4356743
Columbia TriStar Home Video,2500000,Blair Treu,-2094818,Evan Rachel Wood,8,Jessica Barondes,405182
Miramax,100000000,Martin Scorsese,-22188000,Leonardo DiCaprio,12,Jay Cocks,77812000
1492 Pictures,100000000,Chris Columbus,161988482,Daniel Radcliffe,11,J.K. Rowling,261988482
Columbia Pictures Corporation,139000000,Sam Raimi,264706375,Tobey Maguire,5,Stan Lee,403706375
DreamWorks,52000000,Steven Spielberg,112615351,Leonardo DiCaprio,12,Jeff Nathanson,164615351
O2 Filmes,3300000,Fernando Meirelles,4263397,Alexandre Rodrigues,2,Paulo Lins,7563397
R.P. Productions,35000000,Roman Polanski,-2427423,Adrien Brody,3,Ronald Harwood,32572577
Warner Bros.,11000000,Adam Shankman,30227069,Mandy Moore,1,Nicholas Sparks,41227069
Miramax,45000000,Rob Marshall,125687518,Renée Zellweger,1,Bill Condon,170687518
DNA Films,8000000,Danny Boyle,37064915,Cillian Murphy,6,Alex Garland,45064915
New Line Cinema,94000000,Peter Jackson,248551365,Elijah Wood,12,J.R.R. Tolkien,342551365
DreamWorks,48000000,Gore Verbinski,81128133,Naomi Watts,10,Ehren Kruger,129128133
Imagine Entertainment,41000000,Curtis Hanson,75724075,Eminem,11,Scott Silver,116724075
Warner Bros.,84000000,Raja Gosnell,69288182,Matthew Lillard,6,James Gunn,153288182
Fox 2000 Pictures,50000000,Adrian Lyne,2801000,Richard Gere,5,Claude Chabrol,52801000
Twentieth Century Fox Film Corporation,102000000,Steven Spielberg,30072926,Tom Cruise,6,Philip K. Dick,132072926
Slough Pond,4000000,Steven Shainberg,59680,James Spader,10,Erin Cressida Wilson,4059680
Universal Pictures,60000000,Doug Liman,61661683,Franka Potente,6,Tony Gilroy,121661683
Touchstone Pictures,35000000,Kevin Reynolds,19234062,Jim Caviezel,1,Alexandre Dumas,54234062
DreamWorks,80000000,Sam Mendes,24454762,Tom Hanks,7,Max Allan Collins,104454762
Touchstone Pictures,38000000,Andy Tennant,89223418,Reese Witherspoon,9,Douglas J. Eboch,127223418
Lucasfilm,115000000,George Lucas,195675583,Hayden Christensen,5,George Lucas,310675583
Icon Entertainment International,75000000,Randall Wallace,3122718,Mel Gibson,3,Harold G. Moore,78122718
Columbia Pictures Corporation,48000000,David Fincher,48397334,Jodie Foster,3,David Koepp,96397334
Alcon Entertainment,46000000,Christopher Nolan,21355513,Al Pacino,5,Hillary Seitz,67355513
Paramount Pictures,25000000,Stephen Daldry,16675994,Meryl Streep,2,Michael Cunningham,41675994
Universal Pictures,78000000,Brett Ratner,15149898,Anthony Hopkins,10,Thomas Harris,93149898
Constantin Film,33000000,Paul W.S. Anderson,7119709,Milla Jovovich,3,Paul W.S. Anderson,40119709
Dimension Films,20000000,Kurt Wimmer,-18796026,Christian Bale,12,Kurt Wimmer,1203974
Eon Productions,142000000,Lee Tamahori,18942139,Pierce Brosnan,11,Ian Fleming,160942139
Columbia Pictures Corporation,140000000,Barry Sonnenfeld,50418803,Tommy Lee Jones,7,Lowell Cunningham,190418803
Touchstone Pictures,72000000,M. Night Shyamalan,155966634,Mel Gibson,8,M. Night Shyamalan,227966634
Beverly Detroit,19000000,Spike Jonze,3245861,Nicolas Cage,2,Susan Orlean,22245861
New Line Cinema,54000000,Guillermo del Toro,28348319,Wesley Snipes,3,Marv Wolfman,82348319
Gold Circle Films,5000000,Joel Zwick,236438208,Nia Vardalos,8,Nia Vardalos,241438208
Paramount Pictures,60000000,Stuart Baird,-16745591,Patrick Stewart,12,Gene Roddenberry,43254409
Twentieth Century Fox Film Corporation,59000000,Chris Wedge,117387405,Denis Leary,3,Michael J. Wilson,176387405
Revolution Studios,70000000,Rob Cohen,72109382,Vin Diesel,8,Rich Wilkes,142109382
Walt Disney Pictures,80000000,Dean DeBlois,65794338,Daveigh Chase,6,Chris Sanders,145794338
New Line Cinema,63000000,Jay Roach,150307889,Mike Myers,7,Mike Myers,213307889
Fox 2000 Pictures,13000000,Joel Schumacher,33566212,Colin Farrell,4,Larry Cohen,46566212
Handprint Entertainment,12000000,Julie Taymor,13885000,Salma Hayek,11,Hayden Herrera,25885000
Paramount Pictures,18000000,Jake Kasdan,23032915,Colin Hanks,1,Mike White,41032915
Walt Disney Feature Animation,140000000,Ron Clements,-101823217,Joseph Gordon-Levitt,11,Robert Louis Stevenson,38176783
First Light Production,100000000,Kathryn Bigelow,-64831034,Harrison Ford,7,Louis Nowra,35168966
Myriad Pictures,6000000,Walt Becker,15005329,Ryan Reynolds,4,Brent Goldberg,21005329
Spyglass Entertainment,60000000,Rob Bowman,-16938018,Matthew McConaughey,7,Gregg Chabot,43061982
Universal Pictures,60000000,Chuck Russell,31047077,Dwayne Johnson,4,Stephen Sommers,91047077
New Line Cinema,25000000,Paul Thomas Anderson,-7155784,Adam Sandler,11,Paul Thomas Anderson,17844216
Warner Bros.,35000000,Steve Beck,-4886509,Julianna Margulies,10,Mark Hanlon,30113491
Columbia Pictures Corporation,43000000,Roger Kumble,-18281836,Cameron Diaz,4,Nancy Pimental,24718164
Twentieth Century Fox Film Corporation,47000000,Steven Soderbergh,-32029962,George Clooney,11,Stanislaw Lem,14970038
EuropaCorp,21000000,Louis Leterrier,4296447,Jason Statham,10,Luc Besson,25296447
Universal Pictures,30000000,Chris Weitz,11385278,Hugh Grant,5,Nick Hornby,41385278
Regency Enterprises,40000000,Stephen Herek,-25551411,Angelina Jolie,4,John Scott Shepherd,14448589
Beijing New Picture Film Co.,31000000,Yimou Zhang,22710019,Jet Li,8,Feng Li,53710019
Media Asia Films,6428966,Wai-Keung Lau,-6259307,Andy Lau,12,Alan Mak,169659
Warner Bros.,35000000,Michael Rymer,-4663200,Aaliyah,2,Anne Rice,30336800
Lakeshore Entertainment,32000000,Mark Pellington,3746370,Richard Gere,1,Richard Hatem,35746370
Castle Rock Entertainment,60000000,Marc Lawrence,33354851,Sandra Bullock,12,Marc Lawrence,93354851
Columbia Pictures Corporation,38000000,Michael Apted,2007742,Jennifer Lopez,5,Nicholas Kazan,40007742
Flan de Coco Films,8000000,Miguel Arteta,6015786,Jennifer Aniston,8,Mike White,14015786
25th Hour Productions,5000000,Spike Lee,8060843,Edward Norton,1,David Benioff,13060843
Tonic Films,1500000,Eli Roth,19658188,Jordan Ladd,9,Eli Roth,21158188
DreamWorks Animation,80000000,Kelly Asbury,-6719883,Matt Damon,5,John Fusco,73280117
Warner Bros.,80000000,Simon Wells,-23315181,Guy Pearce,3,H.G. Wells,56684819
Dimension Films,15000000,Rick Rosenthal,15354442,Jamie Lee Curtis,7,Debra Hill,30354442
Universal Pictures,30000000,John Stockwell,10390647,Kate Bosworth,8,Susan Orlean,40390647
Metro-Goldwyn-Mayer (MGM),115000000,John Woo,-74085932,Nicolas Cage,6,John Rice,40914068
Warner Bros.,85000000,Andrew Davis,-44922743,Arnold Schwarzenegger,2,Ronald Roose,40077257
Columbia Pictures Corporation,50000000,Steven Brill,76293452,Adam Sandler,6,Clarence Budington Kelland,126293452
Paramount Pictures,68000000,Phil Alden Robinson,50907036,Ben Affleck,5,Tom Clancy,118907036
Revolution Studios,55000000,Wayne Wang,39011225,Jennifer Lopez,12,John Hughes,94011225
New Line Cinema,36000000,Nick Cassavetes,35756802,Denzel Washington,2,James Kearns,71756802
Kingsgate Films,4000000,Roger Avary,2532619,James Van Der Beek,10,Bret Easton Ellis,6532619
Touchstone Pictures,70000000,Joel Schumacher,-39839839,Anthony Hopkins,6,Gary M. Goodman,30160161
Twentieth Century Fox Film Corporation,42000000,Carl Franklin,-456793,Jim Caviezel,4,Joseph Finder,41543207
Walt Disney Pictures,15000000,Jay Russell,4158074,Alexis Bledel,10,Natalie Babbitt,19158074
Dimension Films,38000000,Robert Rodriguez,47846429,Alexa PenaVega,8,Robert Rodriguez,85846429
Touchstone Pictures,21000000,Brad Silberling,-14164144,Jake Gyllenhaal,10,Brad Silberling,6835856
Odeon Films,8000000,David Cronenberg,-6358212,Ralph Fiennes,11,Patrick McGrath,1641788
Miramax,29000000,George Clooney,-12996424,Sam Rockwell,1,Chuck Barris,16003576
New Line Cinema,30000000,Alexander Payne,35016287,Jack Nicholson,1,Louis Begley,65016287
Warner Bros.,50000000,Barbet Schroeder,-18125131,Sandra Bullock,4,Tony Gayton,31874869
Focus Features,13500000,Todd Haynes,2354988,Julianne Moore,1,Todd Haynes,15854988
Happy Madison Productions,34000000,Seth Kearsley,-10556876,Adam Sandler,11,Brooks Arthur,23443124
Avery Pix,10000000,Marcus Raboy,22983713,Ice Cube,11,Ice Cube,32983713
Fuzzy Bunny Films (I),12000000,Tamra Davis,25191304,Britney Spears,2,Shonda Rhimes,37191304
Fox Searchlight Pictures,12000000,Mark Romanek,19597131,Robin Williams,9,Mark Romanek,31597131
Warner Bros.,30000000,Ellory Elkayem,-12677394,David Arquette,7,Ellory Elkayem,17322606
Miramax,17000000,Michael Lehmann,20950822,Josh Hartnett,3,Rob Perez,37950822
CJ Entertainment,4000000,Chan-wook Park,-3954711,Kang-ho Song,3,Jae-sun Lee,45289
Paramount Pictures,15000000,Shawn Levy,32811275,Frankie Muniz,2,Dan Schneider,47811275
United Artists Film Corporation,10000000,Douglas McGrath,-8412827,Charlie Hunnam,1,Charles Dickens,1587173
Blue Train Productions,60000000,Kevin Donovan,-9452002,Jackie Chan,9,Phil Hay,50547998
Columbia Pictures,30000000,Luis Mandoki,-29937464,Kevin Bacon,9,Greg Iles,62536
Revolution Studios,13000000,Ed Decter,15972187,DJ Qualls,5,David Kendall,28972187
2 Loop Films,500000,Lucky McKee,-349723,Angela Bettis,4,Lucky McKee,150277
Muse Productions,2000000,Jonas Åkerlund,-1589759,Jason Schwartzman,2,Will De Los Santos,410241
98 MPH Productions,20000000,John Lee Hancock,55600072,Dennis Quaid,3,Mike Rich,75600072
Screen Gems,10000000,Guy Ritchie,-9992124,Madonna,10,Guy Ritchie,7876
Motion Picture Corporation of America (MPCA),20000000,Mort Nathan,-11413624,Cuba Gooding Jr.,3,Mort Nathan,8586376
Amen Ra Films,20000000,Walter Hill,-7601372,Wesley Snipes,8,David Giler,12398628
Twentieth Century Fox Film Corporation,10000000,Steve Oedekerk,6033556,Steve Oedekerk,1,Steve Oedekerk,16033556
Warner Bros.,16000000,Peter Kosminsky,346122,Michelle Pfeiffer,10,Janet Fitch,16346122
Quinta Communications,35000000,Brian De Palma,-28407897,Rebecca Romijn,11,Brian De Palma,6592103
Alphaville Films,15000000,Ron Shelton,-5940412,Kurt Russell,2,James Ellroy,9059588
Walt Disney Pictures,65000000,Michael Lembeck,74236327,Tim Allen,11,Don Rhymer,139236327
Paramount Pictures,45000000,Roger Michell,21818548,Ben Affleck,4,Chap Taylor,66818548
Dimension Films,40000000,David Twohy,-39394438,Bruce Greenwood,10,Lucas Sussman,605562
Paramount Pictures,26000000,Jonathan Frakes,10985501,Jesse Bradford,3,Rob Hedden,36985501
Touchstone Pictures,40000000,Barry Sonnenfeld,-32737712,Tim Allen,4,Dave Barry,7262288
DreamWorks,16000000,Woody Allen,-11160617,Woody Allen,5,Woody Allen,4839383
Walt Disney Pictures,35000000,Brian Levant,46172560,Cuba Gooding Jr.,1,Jim Kouf,81172560
Twentieth Century Fox Film Corporation,8500000,John Polson,20063926,Jesse Bradford,9,Charles F. Bohl,28563926
Fox 2000 Pictures,20000000,Charles Stone III,36398162,Nick Cannon,12,Shawn Schepps,56398162
Malpaso Productions,50000000,Clint Eastwood,-23800483,Clint Eastwood,8,Michael Connelly,26199517
Paramount Pictures,35000000,Shekhar Kapur,-16693834,Heath Ledger,9,A.E.W. Mason,18306166
Metro-Goldwyn-Mayer (MGM),12000000,Tim Story,63782105,Ice Cube,9,Mark Brown,75782105
Twentieth Century Fox Film Corporation,30000000,John Schultz,21432423,Shad Moss,7,Michael Elliot,51432423
Material,85000000,Tom Dey,-46917288,Robert De Niro,3,Jorge Saralegui,38082712
Columbia Pictures Corporation,70000000,Betty Thomas,-36894400,Eddie Murphy,11,Morton S. Fine,33105600
Castle Rock Entertainment,18000000,D.J. Caruso,-17235446,Val Kilmer,5,Tony Gayton,764554
Revolution Studios,16000000,Perry Andelin Blake,24363530,Dana Carvey,8,Dana Carvey,40363530
Miramax,15000000,Oliver Parker,-6621859,Rupert Everett,6,Oscar Wilde,8378141
Cheyenne Enterprises,70000000,Gregory Hoblit,-50923185,Bruce Willis,2,John Katzenbach,19076815
Silver Sphere Corporation,1000000,Don Coscarelli,1003420,Bruce Campbell,10,Joe R. Lansdale,2003420
Pioneer LDC,3500000,Takashi Shimizu,-3174339,Megumi Okina,1,Takashi Shimizu,325661
Universal Pictures,25000000,Malcolm D. Lee,13230435,Eddie Griffin,5,John Ridley,38230435
BBC Films,10000000,Stephen Frears,-1888640,Chiwetel Ejiofor,9,Steven Knight,8111360
All Girl Productions,27000000,Callie Khouri,42599016,Sandra Bullock,6,Rebecca Wells,69599016
Castle Rock Entertainment,100000000,Ron Underwood,-95579920,Eddie Murphy,8,Neil Cuthbert,4420080
Fox Searchlight Pictures,12500000,Denzel Washington,8578145,Denzel Washington,1,Antwone Fisher,21078145
Columbia Pictures Corporation,120000000,Rob Minkoff,-55043194,Michael J. Fox,7,E.B. White,64956806
Paramount Pictures,7500000,Joe Carnahan,2960089,Ray Liotta,1,Joe Carnahan,10460089
Atlas Entertainment,70000000,John McTiernan,-51009202,Chris Klein,2,William Harrison,18990798
Universal Pictures,60000000,Tom Shadyac,-29936195,Kevin Costner,2,Brandon Camp,30063805
Warner Bros.,55000000,Danny DeVito,-46644185,Robin Williams,3,Adam Resnick,8355815
FTM Productions,29000000,Reginald Hudlin,-12069815,Matthew Perry,8,Jay Scherick,16930185
Morra Brezner Steinberg and Tenenbaum Entertainment (MBST),12000000,Wallace Wolodarsky,-1801234,Barry Watson,3,Joe Jarvis,10198766
Castelao Producciones,10600000,Jaume Balagueró,11563442,Anna Paquin,12,Jaume Balagueró,22163442
Miramax,30000000,Phillip Noyce,-17012353,Michael Caine,3,Graham Greene,12987647
Dimension Films,17000000,Robert Harmon,-4159158,Laura Regan,11,Brendan Hood,12840842
Rumbalara Films,6000000,Phillip Noyce,165429,Everlyn Sampi,1,Doris Pilkington,6165429
Gold Circle Films,4000000,Mars Callahan,-3437941,Mars Callahan,2,Mars Callahan,562059
First Look International,1200000,Matthew Bright,-1193927,Michael Reilly Burke,11,Stephen Johnston,6073
Disney Television Animation,20000000,Robin Budd,28430258,Blayne Weaver,2,Temple Mathews,48430258
Paramount Pictures,25000000,Stephen Gaghan,-14272317,Katie Holmes,10,Stephen Gaghan,10727683
HBO Films,3000000,Patricia Cardoso,2844929,America Ferrera,11,Josefina Lopez,5844929
MDP Worldwide,42000000,William Malone,-28791977,Stephen Dorff,8,Moshe Diamant,13208023
Walt Disney Pictures,35000000,Peter Hastings,-18011004,Haley Joel Osment,7,Mark Perez,16988996
First Look International,10000000,Bruce Beresford,-8516025,Pierce Brosnan,12,Paul Pender,1483975
Alliance Atlantis Communications,11000000,Dewey Nicks,-6185756,Devon Sawa,2,David H. Steinberg,4814244
Franchise Pictures,70000000,Wych Kaosayananda,-55705158,Antonio Banderas,9,Alan B. McElroy,14294842
Warner Bros.,60000000,Harold Ramis,-27877751,Robert De Niro,12,Kenneth Lonergan,32122249
Epsilon Motion Pictures,3500000,Gus Van Sant,-3263734,Casey Affleck,9,Casey Affleck,236266
Focus Puller Inc.,7000000,Paul Schrader,-4937934,Greg Kinnear,11,Robert Graysmith,2062066
Beacon Communications,12500000,Michael Hoffman,1560950,Kevin Kline,11,Ethan Canin,14060950
Focus Features,25000000,Neil LaBute,-14896353,Gwyneth Paltrow,8,A.S. Byatt,10103647
CineWild,10000000,Scott Kalvert,-3955382,Stephen Dorff,5,Paul Kimatian,6044618
United Artists,9000000,Burr Steers,-4318497,Kieran Culkin,10,Burr Steers,4681503
Miramax,11000000,Tom Tykwer,-10225683,Cate Blanchett,8,Krzysztof Kieslowski,774317
Franchise Pictures,60000000,Michael Caton-Jones,-37566085,Robert De Niro,9,Mike McAlary,22433915
Universal Pictures,55000000,Jim Gillespie,-54920839,Sylvester Stallone,1,Howard Swindle,79161
Universal Pictures,60000000,Jonathan Demme,-54649629,Mark Wahlberg,10,Peter Stone,5350371
Les Films Alain Sarde,9000000,Mike Leigh,-8878244,Timothy Spall,5,Mike Leigh,121756
Miramax,2000000,Steven Soderbergh,506446,Julia Roberts,8,Coleman Hough,2506446
Screen Gems,13000000,Don Michael Paul,2361537,Morris Chestnut,11,Don Michael Paul,15361537
Fox Searchlight Pictures,8000000,Rick Famuyiwa,19362712,Taye Diggs,10,Michael Elliot,27362712
New Line Cinema,14000000,Kevin Bray,11482931,Ice Cube,3,Ronald Lang,25482931
Fox Searchlight Pictures,10000000,Bob Dolman,20307416,Susan Sarandon,9,Bob Dolman,30307416
Alameda Films,1800000,Carlos Carrera,3909616,Gael García Bernal,12,Vicente Leñero,5709616
Universal Pictures,11000000,Daisy von Scherler Mayer,-7965819,Jimi Mistry,2,Tracey Jackson,3034181
Solaris,500000,Alex Smith,-486866,Ryan Gosling,1,Alex Smith,13134
United Artists,17500000,Matt Dillon,-17456939,Matt Dillon,3,Matt Dillon,43061
Sogepaq,4000000,Fernando León de Aranoa,-3853598,Javier Bardem,5,Fernando León de Aranoa,146402
Cartoon Network Studios,11000000,Craig McCracken,411644,Cathy Cavadini,7,Charlie Bean,11411644
Paramount Pictures,25000000,Cathy Malkasian,15108697,Tim Curry,12,Arlene Klasky,40108697
Gaylord Films,12000000,Anthony Russo,-11666024,George Clooney,10,Anthony Russo,333976
Morgan Creek Productions,15600000,Jesse Vaughan,-2028183,Miguel A. Núñez Jr.,6,Bradley Allenstein,13571817
Arenas Entertainment,3500000,Franc. Reyes,14004595,John Leguizamo,12,Franc. Reyes,17504595
Cherry Sky Films,250000,Justin Lin,3552390,Parry Shen,4,Ernesto Foronda,3802390
Paramount Pictures,3000000,Tuck Tucker,10684949,Spencer Klein,6,Craig Bartlett,13684949
AAMPI Inc.,11000000,Menno Meyjes,-10472981,John Cusack,6,Menno Meyjes,527019
Wiseau-Films,6000000,Tommy Wiseau,-5998200,Tommy Wiseau,3,Tommy Wiseau,1800
Walt Disney Pictures,140000000,Gore Verbinski,165413918,Johnny Depp,7,Ted Elliott,305413918
Miramax,30000000,Quentin Tarantino,40099045,Uma Thurman,10,Quentin Tarantino,70099045
New Line Cinema,94000000,Peter Jackson,283845905,Elijah Wood,12,J.R.R. Tolkien,377845905
Universal Pictures,40000000,Richard Curtis,19696144,Hugh Grant,11,Richard Curtis,59696144
Egg Films,3000000,Chan-wook Park,-2292519,Min-sik Choi,11,Garon Tsuchiya,707481
United Artists,17000000,Victor Salva,18667218,Jonathan Breck,8,Victor Salva,35667218
Warner Bros.,25000000,Clint Eastwood,65135191,Sean Penn,10,Brian Helgeland,90135191
Universal Pictures,137000000,Ang Lee,-4822766,Eric Bana,6,Stan Lee,132177234
Pixar Animation Studios,94000000,Andrew Stanton,286843261,Albert Brooks,5,Andrew Stanton,380843261
Focus Features,4000000,Sofia Coppola,40585453,Bill Murray,10,Sofia Coppola,44585453
New Line Cinema,9200000,Marcus Nispel,71371655,Jessica Biel,10,Kim Henkel,80571655
Fox Searchlight Pictures,1500000,Catherine Hardwicke,3099680,Evan Rachel Wood,9,Catherine Hardwicke,4599680
Media 8 Entertainment,4500000,Patty Jenkins,29969210,Charlize Theron,1,Patty Jenkins,34469210
Summit Entertainment,12600000,Rob Schmidt,2817771,Eliza Dushku,5,Alan B. McElroy,15417771
Twentieth Century Fox Film Corporation,40000000,Shawn Levy,98614544,Steve Martin,12,Frank B. Gilbreth Jr.,138614544
Warner Bros.,150000000,Lana Wachowski,131492479,Keanu Reeves,5,Lilly Wachowski,281492479
Walt Disney Pictures,20000000,Andrew Davis,47406573,Shia LaBeouf,4,Louis Sachar,67406573
Lakeshore Entertainment,22000000,Len Wiseman,29970690,Kate Beckinsale,9,Kevin Grevioux,51970690
Columbia Pictures Corporation,70000000,Tim Burton,-3742998,Ewan McGregor,1,Daniel Wallace,66257002
Marvel Enterprises,78000000,Mark Steven Johnson,-77568119,Ben Affleck,2,Mark Steven Johnson,431881
Warner Bros.,140000000,Edward Zwick,-28889425,Tom Cruise,12,John Logan,111110575
Paramount Pictures,35000000,Richard Linklater,46261177,Jack Black,10,Mike White,81261177
C-2 Pictures,200000000,Jonathan Mostow,-49628888,Arnold Schwarzenegger,7,James Cameron,150371112
Paramount Pictures,60000000,F. Gary Gray,46128601,Donald Sutherland,5,Troy Kennedy-Martin,106128601
Columbia Pictures Corporation,30000000,James Mangold,22159536,John Cusack,4,Michael Cooney,52159536
New Line Cinema,30000000,Ronny Yu,52622655,Robert Englund,8,Wes Craven,82622655
DreamWorks,24000000,Todd Phillips,51585093,Luke Wilson,2,Court Crandall,75585093
Universal Pictures,76000000,John Singleton,51154901,Paul Walker,6,Gary Scott Thompson,127154901
Warner Bros.,150000000,Lana Wachowski,-10686052,Keanu Reeves,11,Lilly Wachowski,139313948
Angry Films,78000000,Stephen Norrington,-11534796,Sean Connery,7,Alan Moore,66465204
Universal Pictures,100000000,P.J. Hogan,-51537392,Jeremy Sumpter,12,J.M. Barrie,48462608
Spectacle Entertainment Group,7000000,Rob Zombie,5634962,Sid Haig,4,Rob Zombie,12634962
Castle Rock Entertainment,68000000,Lawrence Kasdan,-34284564,Morgan Freeman,3,Stephen King,33715436
Paramount Pictures,95000000,Jan de Bont,-29339804,Angelina Jolie,7,Dean Georgaris,65660196
Miramax,79000000,Anthony Minghella,16636509,Jude Law,12,Charles Frazier,95636509
Spyglass Entertainment,81000000,Tom Shadyac,161829261,Jim Carrey,5,Steve Koren,242829261
Twentieth Century Fox Film Corporation,110000000,Bryan Singer,104949694,Patrick Stewart,5,Zak Penn,214949694
Twentieth Century Fox Film Corporation,150000000,Peter Weir,-56072080,Russell Crowe,11,Patrick O'Brian,93927920
Touchstone Pictures,22000000,Kevin Costner,36331254,Kevin Costner,8,Lauran Paine,58331254
Columbia Pictures Corporation,85000000,Peter Berg,-37273658,Dwayne Johnson,9,R.J. Stewart,47726342
New Line Cinema,33000000,Jon Favreau,140398518,Will Ferrell,11,David Berenbaum,173398518
Lynda Obst Productions,50000000,Donald Petrie,55813373,Kate Hudson,2,Michele Alexander,105813373
Universal Pictures,109000000,Bo Welch,-7850715,Mike Myers,11,Dr. Seuss,101149285
Casual Friday Productions,26000000,Mark Waters,84230332,Jamie Lee Curtis,8,Mary Rodgers,110230332
Columbia Pictures Corporation,120000000,McG,-19169889,Drew Barrymore,6,Ivan Goff,100830111
Columbia Pictures Corporation,130000000,Michael Bay,8608444,Will Smith,7,George Gallo,138608444
Universal Pictures,55000000,Jesse Dylan,49565114,Jason Biggs,8,Adam Herz,104565114
New Line Cinema,30000000,Tim McCanlies,11407470,Haley Joel Osment,9,Tim McCanlies,41407470
New Line Cinema,26000000,David R. Ellis,20961214,A.J. Cook,1,J. Mackye Gruber,46961214
This Is That Productions,20000000,Alejandro González Iñárritu,-3751299,Sean Penn,1,Guillermo Arriaga,16248701
Universal Pictures,50000000,Alan Parker,-30406260,Kevin Spacey,2,Charles Randolph,19593740
CJ Entertainment,2800000,Joon-ho Bong,-2785869,Kang-ho Song,5,Joon-ho Bong,14131
DreamWorks,15000000,Vadim Perelman,-1994515,Jennifer Connelly,1,Andre Dubus III,13005485
Walt Disney Pictures,17000000,Jim Fall,25672630,Hilary Duff,5,Susan Estelle Jansen,42672630
Columbia Pictures Corporation,29000000,Robert Rodriguez,27359780,Antonio Banderas,9,Robert Rodriguez,56359780
Paramount Pictures,60000000,Jon Amiel,-28813104,Aaron Eckhart,3,Cooper Layne,31186896
Dimension Films,48000000,David Zucker,62003217,Anna Faris,10,Craig Mazin,110003217
Revolution Studios,65000000,Mike Newell,-1139058,Julia Roberts,12,Lawrence Konner,63860942
Gray Daisy Films,10000000,Vincent Gallo,-9634266,Vincent Gallo,11,Vincent Gallo,365734
Revolution Studios,75000000,Peter Segal,60645823,Jack Nicholson,4,David Dorfman,135645823
Fox 2000 Pictures,35000000,Peyton Reed,-14701793,Ewan McGregor,5,Eve Ahlert,20298207
Miramax,30000000,Robert Benton,-24618773,Anthony Hopkins,10,Philip Roth,5381227
Plunge Pictures LLC,120000,Chris Kentis,30490863,Blanchard Ryan,8,Chris Kentis,30610863
Touchstone Pictures,18000000,Audrey Wells,25610723,Diane Lane,9,Frances Mayes,43610723
Cheyenne Enterprises,70000000,Antoine Fuqua,-26265124,Bruce Willis,3,Alex Lasker,43734876
Revolution Studios,75000000,Ron Shelton,-44986654,Harrison Ford,6,Robert Souza,30013346
Dimension Films,38000000,Robert Rodriguez,73761982,Daryl Sabara,7,Robert Rodriguez,111761982
DreamWorks,60000000,Patrick Gilmore,-33516548,Brad Pitt,7,John Logan,26483452
Warner Bros.,20000000,Dennie Gordon,15990505,Amanda Bynes,4,William Douglas-Home,35990505
Revolution Studios,60000000,Ron Howard,-33099664,Tommy Lee Jones,11,Thomas Eidson,26900336
Columbia Pictures Corporation,80000000,Nancy Meyers,44728738,Jack Nicholson,12,Nancy Meyers,124728738
Columbia Pictures Corporation,40000000,Mathieu Kassovitz,19694580,Halle Berry,11,Sebastian Gutierrez,59694580
Columbia Pictures Corporation,80000000,Clark Johnson,36934650,Samuel L. Jackson,8,Robert Hamner,116934650
Universal Pictures,35000000,Peter Howitt,-6917634,Rowan Atkinson,7,Neal Purvis,28082366
Metro-Goldwyn-Mayer (MGM),26000000,Harald Zwart,21811138,Frankie Muniz,3,Ashley Miller,47811138
Walt Disney Pictures,90000000,Rob Minkoff,-14152734,Eddie Murphy,11,David Berenbaum,75847266
Phoenix Pictures,50000000,John McTiernan,-23463880,John Travolta,3,James Vanderbilt,26536120
Columbia Pictures Corporation,23000000,Terry Zwigoff,37060328,Billy Bob Thornton,11,Glenn Ficarra,60060328
Miramax,30000000,Bruno Barreto,-14410542,Gwyneth Paltrow,3,Eric Wald,15589458
Paramount Pictures,60000000,John Woo,-6209549,Ben Affleck,12,Philip K. Dick,53790451
Warner Bros.,62000000,Ridley Scott,-25093540,Nicolas Cage,9,Eric Garcia,36906460
Revolution Studios,60000000,Steve Carr,44297061,Eddie Murphy,5,Geoff Rodkey,104297061
Touchstone Pictures,46000000,Roger Donaldson,6802140,Al Pacino,1,Roger Towne,52802140
HBO Films,3000000,Gus Van Sant,-1773000,Elias McConnell,11,Gus Van Sant,1227000
Walt Disney Feature Animation Florida,128000000,Aaron Blaise,-42663723,Joaquin Phoenix,10,Tab Murphy,85336277
DIA Productions GmbH & Co. KG,36000000,F. Gary Gray,-9816803,Vin Diesel,4,Christian Gudegast,26183197
Warner Bros.,16000000,John Whitesell,18308901,Jamie Kennedy,4,Fax Bahr,34308901
Touchstone Pictures,33000000,Adam Shankman,99716677,Steve Martin,3,Jason Filardi,132716677
Mandalay Pictures,35000000,Martin Campbell,-30573703,Clive Owen,10,Caspian Tredwell-Owen,4426297
Paramount Pictures,80000000,Richard Donner,-60518057,Paul Walker,11,Michael Crichton,19481943
Warner Bros.,80000000,Joe Dante,-59008636,Brendan Fraser,11,Larry Doyle,20991364
Metro-Goldwyn-Mayer (MGM),50000000,Carl Franklin,-9094723,Denzel Washington,10,David Collard,40905277
Lions Gate Films,5000000,James Cox,-3943898,Val Kilmer,10,James Cox,1056102
Regency Enterprises,60000000,Gary Fleder,-10556372,John Cusack,10,John Grisham,49443628
Twentieth Century Fox Film Corporation,55000000,Bobby Farrelly,-21167259,Matt Damon,12,Charles B. Wessler,33832741
Castle Rock Entertainment,60000000,David McNally,6934963,Anthony Anderson,1,Steve Bing,66934963
Universal Pictures,60000000,Joel Coen,-24672372,George Clooney,10,Robert Ramsey,35327628
Revolution Studios,11000000,Jonathan Liebesman,21551396,Chaney Kley,1,Joe Harris,32551396
Universal Pictures,18000000,Bille Woodruff,12222640,Jessica Alba,12,Alonzo Brown,30222640
Revolution Studios,54000000,Martin Brest,-47931265,Ben Affleck,8,Martin Brest,6068735
Pathe Productions,12000000,Jane Campion,-7249398,Meg Ryan,10,Jane Campion,4750602
Twentieth Century Fox Film Corporation,38000000,Brian Helgeland,-30340253,Heath Ledger,9,Brian Helgeland,7659747
Lakeshore Entertainment,55000000,William Friedkin,-20761389,Tommy Lee Jones,3,David Griffiths,34238611
New Line Cinema,19000000,Troy Miller,7276465,Derek Richardson,6,Peter Farrelly,26276465
Twentieth Century Fox Film Corporation,18000000,Shawn Levy,38127162,Ashton Kutcher,1,Sam Harper,56127162
Touchstone Pictures,50000000,David Dobkin,10476872,Jackie Chan,2,Alfred Gough,60476872
Metro-Goldwyn-Mayer (MGM),45000000,Charles Herman-Wurmfeld,45186328,Reese Witherspoon,7,Amanda Brown,90186328
Universal Pictures,87000000,Gary Ross,33277854,Tobey Maguire,7,Laura Hillenbrand,120277854
Metro-Goldwyn-Mayer (MGM),20000000,Boaz Yakin,16922190,Brittany Murphy,8,Julia Dahl,36922190
SenArt Films,500000,Tom McCarthy,5239376,Peter Dinklage,12,Tom McCarthy,5739376
Boll Kino Beteiligungs GmbH & Co. KG,7000000,Uwe Boll,3249719,Jonathan Cherry,10,Mark A. Altman,10249719
Warner Bros.,30000000,Andrzej Bartkowiak,4604054,Jet Li,2,John O'Brien,34604054
Revolution Studios,35000000,Michael Tollin,17277485,Cuba Gooding Jr.,10,Mike Rich,52277485
Emperor Multimedia Group (EMG),41000000,Gordon Chan,-18891023,Jackie Chan,8,Alfred Cheung,22108977
Turner Pictures (I),56000000,Ron Maxwell,-43129431,Stephen Lang,2,Jeff Shaara,12870569
Lions Gate Films,6000000,Billy Ray,-3779992,Hayden Christensen,11,Buzz Bissinger,2220008
Metro-Goldwyn-Mayer (MGM),20000000,Chris Koch,-4591178,Jason Lee,1,Greg Glienna,15408822
New Line Cinema,22000000,Glen Morgan,-15113911,Crispin Glover,3,Glen Morgan,6886089
19 Entertainment,12000000,Robert Iscove,-7077834,Kelly Clarkson,6,Kim Fuller,4922166
World of Wonder,5000000,Fenton Bailey,-4271747,Macaulay Culkin,10,Fenton Bailey,728253
DreamWorks,18000000,Woody Allen,-14796956,Woody Allen,9,Woody Allen,3203044
Metro-Goldwyn-Mayer (MGM),52000000,Paul Hunter,-28979512,Yun-Fat Chow,4,Ethan Reiff,23020488
Franchise Pictures,40000000,Andrew Fleming,-19559373,Albert Brooks,5,Andrew Bergman,20440627
Klasky-Csupo,25000000,John Eng,14399750,Jodi Carlisle,6,Kate Boutilier,39399750
DreamWorks,35200000,Chris Rock,2588228,Chris Rock,3,Chris Rock,37788228
Les Armateurs,9500000,Sylvain Chomet,-2497745,Michèle Caucheteux,2,Sylvain Chomet,7002255
Paramount Pictures,17000000,Sam Weisman,5734486,David Spade,9,Fred Wolf,22734486
Jasmine Productions Inc.,2500000,David Gordon Green,-1951288,Zooey Deschanel,8,David Gordon Green,548712
Miramax,40000000,Danny DeVito,-30307865,Ben Stiller,9,Larry Doyle,9692135
Go Films,780000,Ryan Little,530470,Corbin Allred,3,Geoffrey Panos,1310470
Touchstone Pictures,10000000,Nigel Cole,21041759,Helen Mirren,1,Juliette Towhidi,31041759
British Broadcasting Corporation (BBC),8000000,Tim Fywell,-6825861,Romola Garai,8,Dodie Smith,1174139
Lions Gate Films,15000000,James Foley,-2787583,Edward Burns,4,Doug Jung,12212417
ContentFilm,3200000,Wayne Kramer,5043880,William H. Macy,1,Frank Hannah,8243880
Touchstone Pictures,17000000,Joel Schumacher,-15428496,Cate Blanchett,10,Carol Doyle,1571504
Mepris Films,4000000,Neil LaBute,-3267759,Paul Rudd,5,Neil LaBute,732241
United Artists,300000,Peter Hedges,2228664,Katie Holmes,11,Peter Hedges,2528664
Funny Boy Films,850000,C. Jay Cox,-30061,Wes Ramsey,7,C. Jay Cox,819939
Dimension Films,14000000,David Zucker,1550605,Ashton Kutcher,8,David Dorfman,15550605
Focus Features,16000000,Clare Kilner,-1891482,Mandy Moore,7,Sarah Dessen,14108518
Disney Television Animation,20000000,Steve Trenbirth,27887943,John Goodman,2,Karl Geurs,47887943
Icon Productions,8000000,Keith Gordon,-7663544,Robert Downey Jr.,11,Dennis Potter,336456
Metro-Goldwyn-Mayer (MGM),17000000,John Hoffman,20566230,Liam Aiken,10,Zeke Richardson,37566230
Paramount Pictures,15000000,Jonathan Lynn,15238577,Cuba Gooding Jr.,9,Elizabeth Hunter,30238577
Brown Sauce Film Productions,5000000,John Crowley,-4103007,Cillian Murphy,4,Mark O'Rowe,896993
British Broadcasting Corporation (BBC),7500000,Michael Winterbottom,-7302852,Tim Robbins,9,Frank Cottrell Boyce,197148
Cobalt Media Group,6800000,Damian Nieman,-6766775,Joe Nicolo,5,Damian Nieman,33225
Sony Pictures Classics,15000000,Robert Altman,-12718415,Neve Campbell,5,Neve Campbell,2281585
Epsilon Motion Pictures,30000000,Rob Reiner,-15791616,Luke Wilson,6,Jeremy Leven,14208384
Australian Film Finance Corporation (AFFC),5740000,Sue Brooks,-5092946,Toni Collette,9,Alison Tilson,647054
ApolloProMedia GmbH & Co. 1. Filmproduktion KG (I),15000000,Bronwen Hughes,-14980933,Thomas Jane,10,Bima Stagg,19067
Alliance Atlantis Communications,10000000,Richard Kwietniowski,-8988946,Philip Seymour Hoffman,9,Gary Stephen Ross,1011054
Professor Bright Films,20000,Ben Coccio,-12779,Cal Robertson,1,Ben Coccio,7221
LivePlanet,1000000,Efram Potelle,-720718,Shia LaBeouf,8,Erica Beeney,279282
New Line Cinema,29000000,Nick Cassavetes,52001787,Gena Rowlands,6,Jeremy Leven,81001787
Evolution Entertainment,1200000,James Wan,54800369,Cary Elwes,10,Leigh Whannell,56000369
Warner Bros.,175000000,Wolfgang Petersen,-41621744,Brad Pitt,5,Homer,133378256
Touchstone Pictures,60000000,M. Night Shyamalan,54197520,Sigourney Weaver,7,M. Night Shyamalan,114197520
Revolution Studios,66000000,Guillermo del Toro,-6376042,Ron Perlman,4,Guillermo del Toro,59623958
Paramount Pictures,17000000,Mark Waters,69058055,Lindsay Lohan,4,Rosalind Wiseman,86058055
Warner Bros.,130000000,Alfonso Cuarón,119358727,Daniel Radcliffe,6,J.K. Rowling,249358727
Pixar Animation Studios,92000000,Brad Bird,169441092,Craig T. Nelson,11,Brad Bird,261441092
Focus Features,20000000,Michel Gondry,14400301,Jim Carrey,3,Charlie Kaufman,34400301
Twentieth Century Fox Film Corporation,125000000,Roland Emmerich,61740799,Dennis Quaid,5,Roland Emmerich,186740799
Miramax,30000000,Quentin Tarantino,36208183,Uma Thurman,4,Quentin Tarantino,66208183
Lions Gate Films,33000000,Jonathan Hensleigh,682273,Thomas Jane,4,Jonathan Hensleigh,33682273
DreamWorks,25000000,Jeff Schaffer,-7281777,Scott Mechlowicz,2,Alec Berg,17718223
Universal Pictures,160000000,Stephen Sommers,-39822916,Hugh Jackman,5,Stephen Sommers,120177084
Warner Bros.,70000000,Joel Schumacher,-18731185,Gerard Butler,12,Gaston Leroux,51268815
Regency Enterprises,25000000,Luke Greenfield,-10410556,Emile Hirsch,4,David Wagner,14589444
Revolution Studios,37000000,Keenen Ivory Wayans,33831760,Marlon Wayans,6,Keenen Ivory Wayans,70831760
Filmax Group,5000000,Brad Anderson,-3917285,Christian Bale,12,Scott Kosar,1082715
Bob Yari Productions,6500000,Paul Haggis,48080300,Don Cheadle,5,Paul Haggis,54580300
Fox Searchlight Pictures,400000,Jared Hess,44140956,Jon Heder,8,Jared Hess,44540956
Warner Bros.,30000000,Clint Eastwood,70492203,Hilary Swank,1,Paul Haggis,100492203
BenderSpink,13000000,Eric Bress,44938693,Ashton Kutcher,1,J. Mackye Gruber,57938693
Rogue Pictures,12000000,Don Mancini,5083732,Jennifer Tilly,11,Don Mancini,17083732
Strike Entertainment,26000000,Zack Snyder,33020957,Sarah Polley,3,George A. Romero,59020957
Icon Productions,30000000,Mel Gibson,340782930,Jim Caviezel,2,Benedict Fitzgerald,370782930
Touchstone Pictures,50000000,Wes Anderson,-25993274,Bill Murray,12,Wes Anderson,24006726
Columbia Pictures,27000000,Mike Nichols,6987757,Natalie Portman,12,Patrick Marber,33987757
Buena Vista Home Entertainment,24000000,Hayao Miyazaki,-19288904,Chieko Baishô,6,Hayao Miyazaki,4711096
Forward Pass,110000000,Martin Scorsese,-7391173,Leonardo DiCaprio,12,John Logan,102608827
Twentieth Century Fox Film Corporation,20000000,Rawson Marshall Thurber,94326736,Ben Stiller,6,Rawson Marshall Thurber,114326736
Touchstone Pictures,120000000,Antoine Fuqua,-68117756,Clive Owen,7,David Franzoni,51882244
Paramount Pictures,140000000,Brad Silberling,-21372883,Jim Carrey,12,Robert Gordon,118627117
Revolution Studios,37000000,Gary Winick,20231747,Jennifer Garner,4,Josh Goldsmith,57231747
Miramax,25000000,Marc Forster,26680613,Johnny Depp,12,Allan Knee,51680613
Columbia Pictures Corporation,200000000,Sam Raimi,173585825,Tobey Maguire,6,Stan Lee,373585825
Paramount Pictures,65000000,Michael Mann,36005703,Tom Cruise,8,Stuart Beattie,101005703
Twentieth Century Fox Film Corporation,120000000,Alex Proyas,24801023,Will Smith,7,Jeff Vintar,144801023
Universal Pictures,75000000,Paul Greengrass,101241941,Matt Damon,7,Robert Ludlum,176241941
DreamWorks,150000000,Andrew Adamson,286471036,Mike Myers,5,William Steig,436471036
Fox 2000 Pictures,70000000,Tony Scott,7911774,Denzel Washington,4,A.J. Quinnell,77911774
Warner Bros.,155000000,Oliver Stone,-120702809,Colin Farrell,11,Oliver Stone,34297191
Universal Pictures,105000000,David Twohy,-47238988,Vin Diesel,6,Jim Wheat,57761012
Warner Bros.,20000000,Mark Rosman,31438175,Hilary Duff,7,Leigh Dunlap,51438175
DreamWorks,60000000,Steven Spielberg,17872883,Tom Hanks,6,Andrew Niccol,77872883
Fox Searchlight Pictures,12000000,Alexander Payne,59503593,Paul Giamatti,1,Rex Pickett,71503593
Columbia Pictures Corporation,75000000,Peter Segal,45908074,Adam Sandler,2,George Wing,120908074
DreamWorks,26000000,Adam McKay,59288303,Will Ferrell,7,Will Ferrell,85288303
Twentieth Century Fox Film Corporation,60000000,Paul W.S. Anderson,20282231,Sanaa Lathan,8,Dan O'Bannon,80282231
Walt Disney Pictures,100000000,Jon Turteltaub,73008894,Nicolas Cage,11,Jim Kouf,173008894
Walt Disney Pictures,40000000,Garry Marshall,55170481,Anne Hathaway,8,Meg Cabot,95170481
New Line Cinema,65000000,David S. Goyer,-12588094,Wesley Snipes,12,David S. Goyer,52411906
Universal Pictures,30000000,Peter Berg,31188085,Billy Bob Thornton,10,Buzz Bissinger,61188085
Warner Bros.,110000000,Steven Soderbergh,15544280,George Clooney,12,George Nolfi,125544280
Universal Pictures,42000000,John Hamburg,46097164,Ben Stiller,1,John Hamburg,88097164
Lions Gate Films,25000000,Guy Ferland,-10838410,Diego Luna,2,Kate Gunzinger,14161590
ERBP,7000,Shane Carruth,417760,Shane Carruth,5,Shane Carruth,424760
Endgame Entertainment,9000000,Danny Leiner,9225165,John Cho,7,Jon Hurwitz,18225165
Paramount Pictures,30000000,Trey Parker,2774834,Trey Parker,10,Trey Parker,32774834
Miramax,35000000,Tommy O'Haver,-12081613,Anne Hathaway,4,Laurie Craig,22918387
Camelot Pictures,2500000,Zach Braff,24282316,Zach Braff,8,Zach Braff,26782316
Paramount Pictures,90000000,Frank Oz,-30515258,Nicole Kidman,6,Ira Levin,59484742
Metro-Goldwyn-Mayer (MGM),10000000,Joe Nussbaum,-563610,Alexa PenaVega,7,Elisa Bell,9436390
Columbia Pictures,10000000,Takashi Shimizu,100359362,Sarah Michelle Gellar,10,Stephen Susco,110359362
Walt Disney Pictures,15000000,Sara Sugarman,14331068,Lindsay Lohan,2,Dyan Sheldon,29331068
Castle Rock Entertainment,165000000,Robert Zemeckis,18373735,Tom Hanks,11,Chris Van Allsburg,183373735
Davis Films / Impact Pictures,45000000,Alexander Witt,6201453,Milla Jovovich,9,Paul W.S. Anderson,51201453
Warner Independent Pictures (WIP),2700000,Richard Linklater,3092822,Ethan Hawke,7,Richard Linklater,5792822
United Artists,17500000,Terry George,5972900,Don Cheadle,2,Keir Pearson,23472900
Grand Slam Productions,40000000,David Koepp,8022900,Johnny Depp,3,Stephen King,48022900
Universal Pictures,80000000,Jay Roach,199261160,Ben Stiller,12,Greg Glienna,279261160
Paramount Pictures,80000000,Jonathan Demme,-14044370,Denzel Washington,7,Richard Condon,65955630
DreamWorks Animation,75000000,Bibo Bergeron,85861908,Will Smith,10,Michael J. Wilson,160861908
Warner Bros.,45000000,D.J. Caruso,-12317658,Angelina Jolie,3,Michael Pye,32682342
Warner Bros.,100000000,Pitof,-59797621,Halle Berry,7,Bob Kane,40202379
Columbia Pictures Film Production Asia,20000000,Stephen Chow,-2891409,Stephen Chow,4,Stephen Chow,17108591
Touchstone Pictures,35000000,Ethan Coen,4799191,Tom Hanks,3,Joel Coen,39799191
Metro-Goldwyn-Mayer (MGM),56000000,Kevin Bray,-10139961,Dwayne Johnson,4,Mort Briskin,45860039
Warner Bros.,80000000,Raja Gosnell,4216833,Freddie Prinze Jr.,3,William Hanna,84216833
Columbia Pictures Corporation,80000000,James L. Brooks,-37955679,Adam Sandler,12,James L. Brooks,42044321
Paramount Pictures,70000000,Kerry Conran,-32239920,Gwyneth Paltrow,9,Kerry Conran,37760080
Walden Media,110000000,Frank Coraci,-85991863,Jackie Chan,6,Jules Verne,24008137
Paramount Pictures,30000000,Stephen Hillenburg,55417988,Jeffrey Tambor,11,Stephen Hillenburg,85417988
Pop Pop Productions,28000000,Gavin O'Connor,36378093,Kurt Russell,2,Eric Guggenheim,64378093
Universal Pictures,40000000,Taylor Hackford,35331600,Jamie Foxx,10,Taylor Hackford,75331600
Universal Pictures,40000000,Beeban Kidron,226215,Renée Zellweger,11,Helen Fielding,40226215
New Line Cinema,15000000,Sean McNamara,-4588020,Hilary Duff,10,Mitch Rotter,10411980
2003 Productions,47000000,Jean-Pierre Jeunet,-40832183,Audrey Tautou,1,Sébastien Japrisot,6167817
Metro-Goldwyn-Mayer (MGM),30000000,Paul McGuigan,-17168879,Josh Hartnett,9,Gilles Mimouni,12831121
Twentieth Century Fox Film Corporation,25000000,Tim Story,11611066,Queen Latifah,10,Luc Besson,36611066
Dimension Films,60000000,Todd Phillips,28237754,Ben Stiller,3,William Blinn,88237754
Twentieth Century Fox Film Corporation,45000000,John Moore,-23990820,Dennis Quaid,12,Lukas Heller,21009180
Alcon Entertainment,23000000,Andy Cadiff,-10810486,Mandy Moore,1,Derek Guiley,12189514
Fox 2000 Pictures,18000000,Bart Freundlich,-1297136,Kristen Stewart,2,Nikolaj Arcel,16702864
Universal Pictures,31000000,Richard Loncraine,-13998867,Kirsten Dunst,9,Adam Brooks,17001133
Screen Gems,3500000,Angela Robinson,-3403207,Sara Foster,3,Angela Robinson,96793
New Line Cinema,25000000,David R. Ellis,7003620,Kim Basinger,9,Larry Cohen,32003620
Dimension Films,27000000,Renny Harlin,-22519256,Val Kilmer,5,Wayne Kramer,4480744
Fox Searchlight Pictures,22000000,David O. Russell,-9215287,Jason Schwartzman,10,David O. Russell,12784713
Twentieth Century Fox Film Corporation,35000000,Peter Hewitt,40369589,Breckin Meyer,6,Jim Davis,75369589
Fox Searchlight Pictures,11000000,Bill Condon,-785353,Liam Neeson,1,Bill Condon,10214647
Revolution Studios,42000000,Joseph Ruben,24641205,Julianne Moore,9,Gerald Di Pego,66641205
Paramount Pictures,19000000,Steven Brill,39169327,Matthew Lillard,8,Fred Wolf,58169327
Miramax,35000000,Kevin Smith,-9733871,Ben Affleck,3,Kevin Smith,25266129
Focus Features,23000000,Mira Nair,-6863524,Reese Witherspoon,9,Matthew Faulk,16136476
Jet Tone Films,12000000,Kar-Wai Wong,-11738519,Tony Chiu-Wai Leung,9,Kar-Wai Wong,261481
Metro-Goldwyn-Mayer (MGM),16000000,Jessy Terrero,-2077789,Dwayne Adway,5,Bo Zenga,13922211
Working Title Films,57000000,Jonathan Frakes,-50231945,Bill Paxton,7,Gerry Anderson,6768055
Morgan Creek Productions,50000000,Renny Harlin,-8178014,Stellan Skarsgård,8,William Peter Blatty,41821986
Broken Lizard Industries,8600000,Jay Chandrasekhar,-3607841,Jay Chandrasekhar,2,Jay Chandrasekhar,4992159
DreamWorks,24000000,Robert Luketic,-6928038,Kate Bosworth,1,Victor Levin,17071962
Paramount Pictures,40000000,Brian Robbins,-29612294,Scarlett Johansson,1,Marc Hyman,10387706
United Artists,5000000,Brian Dannelly,3940582,Jena Malone,6,Brian Dannelly,8940582
Touchstone Pictures,100000000,Joe Johnston,-32713269,Viggo Mortensen,3,John Fusco,67286731
Whitewater Films,500000,Jacob Estes,103951,Rory Culkin,9,Jacob Estes,603951
Screen Gems,8000000,Chris Stokes,32066497,Omarion Grandberry,1,Chris Stokes,40066497
Revolution Studios,60000000,Joe Roth,13780539,Tim Allen,11,John Grisham,73780539
New Line Cinema,58000000,Brett Ratner,-29671868,Pierce Brosnan,11,Paul Zbyszewski,28328132
Warner Bros.,40000000,Joseph Kahn,-18784941,Martin Henderson,1,Matt Johnson,21215059
Lions Gate Films,23000000,Kevin Spacey,-16681291,Kevin Spacey,12,Kevin Spacey,6318709
Fine Line Features,15000000,John Waters,-13660332,Tracey Ullman,9,John Waters,1339668
Warner Bros.,30000000,Dennie Gordon,-15981636,Mary-Kate Olsen,5,Emily Fox,14018364
Regency Enterprises,30000000,Forest Whitaker,-20944990,Katie Holmes,9,Jessica Bendinger,9055010
Movision,18000000,Michael Radford,-14234415,Al Pacino,2,William Shakespeare,3765585
New Line Cinema,20000000,Jonathan Glazer,-14994117,Nicole Kidman,10,Jean-Claude Carrière,5005883
Canal+ España,5000000,Pedro Almodóvar,211842,Gael García Bernal,2,Pedro Almodóvar,5211842
Paramount Pictures,60000000,Charles Shyer,-46600188,Jude Law,11,Bill Naughton,13399812
Pathé Pictures International,7000000,Gurinder Chadha,-398921,Martin Henderson,3,Jane Austen,6601079
Shangri-La Entertainment,50000000,George Armitage,-43528606,Owen Wilson,1,Elmore Leonard,6471394
Dylan Sellers Productions,26000000,Kevin Allen,-2777139,Frankie Muniz,3,Jeffrey Jurgensen,23222861
Miramax,50000000,Peter Chelsom,7890460,Richard Gere,10,Masayuki Suo,57890460
Touchstone Pictures,107000000,John Lee Hancock,-84585039,Dennis Quaid,4,Leslie Bohem,22414961
Touchstone Pictures,55000000,Jay Russell,19541707,Joaquin Phoenix,10,Lewis Colick,74541707
Screen Gems,25000000,Dwight H. Little,7238923,Morris Chestnut,8,Hans Bauer,32238923
Touchstone Pictures,50000000,Garry Marshall,-12513862,Kate Hudson,5,Patrick J. Clifton,37486138
ApolloMedia Distribution,20000000,Bob Clark,-10890678,Jon Voight,8,Steven Paul,9109322
DreamWorks,40000000,Barry Levinson,-27818516,Ben Stiller,4,Steve Adams,12181484
Nine Yards Two Productions,40000000,Howard Deutch,-23676031,Bruce Willis,4,Mitchell Kapner,16323969
Metro-Goldwyn-Mayer (MGM),20000000,Irwin Winkler,-6662701,Kevin Kline,8,Jay Cocks,13337299
Bazelevs Production,4200000,Timur Bekmambetov,-2712523,Konstantin Khabenskiy,3,Timur Bekmambetov,1487477
Yash Raj Films,7000000,Yash Chopra,-4078262,Shah Rukh Khan,11,Aditya Chopra,2921738
Paramount Pictures,50000000,Philip Kaufman,-24804950,Ashley Judd,2,Sarah Thorp,25195050
Walt Disney Pictures,110000000,Will Finn,-59969539,Judi Dench,4,Will Finn,50030461
Not specified,26000000,Paul Weitz,19489752,Dennis Quaid,1,Paul Weitz,45489752
Twentieth Century Fox Film Corporation,26000000,Joel Zwick,22116322,Kenan Thompson,12,Bill Cosby,48116322
Fox Searchlight Pictures,12000000,Christopher Erskin,19179516,Cedric the Entertainer,4,Todd R. Jones,31179516
Motion Picture Corporation of America (MPCA),5000000,Mick Garris,-4898893,Jonathan Jackson,2,Mick Garris,101107
Franchise Pictures,19250000,David Mamet,-14815568,Val Kilmer,3,David Mamet,4434432
Deep River Productions,28000000,Peter Howitt,-10151678,Pierce Brosnan,4,Aline Brosh McKenna,17848322
HBO Films,3000000,Joshua Marston,3517198,Catalina Sandino Moreno,8,Joshua Marston,6517198
40 Acres & A Mule Filmworks,8000000,Spike Lee,-7634866,Anthony Mackie,7,Michael Genet,365134
Bob Yari Productions,6000000,David Duchovny,-5628919,David Duchovny,4,David Duchovny,371081
Revolution Studios,35000000,Nick Hurran,-14577793,Brittany Murphy,8,Melissa Carter,20422207
Les Films Alain Sarde,11000000,Mike Leigh,-7246194,Imelda Staunton,2,Mike Leigh,3753806
Eulogy Productions LLC,6500000,Michael Clancy,-6429473,Ray Romano,9,Michael Clancy,70527
Twentieth Century Fox Film Corporation,26000000,Donald Petrie,-11530572,Gene Hackman,2,Doug Richardson,14469428
Paramount Pictures,27000000,E. Elias Merhige,-18274187,Aaron Eckhart,8,Zak Penn,8725813
Ariztical Entertainment,50000,Q. Allan Brocka,105212,Scott Lunsford,2,Q. Allan Brocka,155212
Lions Gate Films,25000000,Nick Hamm,-10620249,Robert De Niro,4,Mark Bomback,14379751
Metro-Goldwyn-Mayer (MGM),18000000,Kevin Rodney Sullivan,47111277,Ice Cube,2,Mark Brown,65111277
Serendipity Point Films,18000000,István Szabó,-10260951,Annette Bening,2,W. Somerset Maugham,7739049
Front Street Pictures,3000000,John Curran,-962455,Mark Ruffalo,9,Andre Dubus,2037545
Kim Ki-Duk Film,1000000,Ki-duk Kim,-761493,Seung-yeon Lee,4,Ki-duk Kim,238507
Touchstone Pictures,30000000,Charles Stone III,-8199698,Bernie Mac,9,Eric Champnella,21800302
Lucky 7 Productions LLC,12000000,Mick Davis,-11804622,Andy Garcia,9,Mick Davis,195378
DreamWorks,45000000,Mike Mitchell,-33336844,Ben Affleck,10,Deborah Kaplan,11663156
Universal Pictures,20000000,Michael Lembeck,-11945720,Nia Vardalos,4,Nia Vardalos,8054280
Hart-Sharp Entertainment,6500000,Michael Mayer,-5470128,Colin Farrell,10,Michael Cunningham,1029872
4 Kids Entertainment,20000000,Hatsuki Tsuji,-237310,Dan Green,8,Masahiro Hikokubo,19762690
Rent Productions LLC,40000000,Chris Columbus,-10922453,Taye Diggs,11,Stephen Chbosky,29077547
Warner Bros.,150000000,Tim Burton,56459076,Johnny Depp,7,Roald Dahl,206459076
Warner Bros.,150000000,Mike Newell,140013036,Daniel Radcliffe,11,Steve Kloves,290013036
Warner Bros.,150000000,Christopher Nolan,56852432,Christian Bale,6,Bob Kane,206852432
Universal Pictures,40000000,Joss Whedon,-14485483,Nathan Fillion,9,Joss Whedon,25514517
Warner Bros.,54000000,James McTeigue,16511035,Hugo Weaving,3,Lilly Wachowski,70511035
Dimension Films,40000000,Frank Miller,34103820,Mickey Rourke,4,Frank Miller,74103820
Focus Features,28000000,Joe Wright,10405088,Keira Knightley,11,Jane Austen,38405088
Touchstone Pictures,50000000,Garth Jennings,1085416,Martin Freeman,4,Douglas Adams,51085416
Focus Features,14000000,Ang Lee,69043761,Jake Gyllenhaal,1,Annie Proulx,83043761
New Line Cinema,40000000,David Dobkin,169218368,Owen Wilson,7,Steve Faber,209218368
Walt Disney Pictures,180000000,Andrew Adamson,111709845,Tilda Swinton,12,Ann Peacock,291709845
Paramount Pictures,82000000,Peter Segal,76119460,Adam Sandler,5,Albert S. Ruddy,158119460
Hostel LLC,4800000,Eli Roth,42526473,Jay Hernandez,1,Eli Roth,47326473
Twentieth Century Fox Film Corporation,130000000,Ridley Scott,-82601587,Orlando Bloom,5,William Monahan,47398413
Lucasfilm,113000000,George Lucas,267262555,Hayden Christensen,5,George Lucas,380262555
Paramount Pictures,132000000,Steven Spielberg,102280354,Tom Cruise,6,Josh Friedman,234280354
Warner Bros.,100000000,Francis Lawrence,-24023822,Keanu Reeves,2,Jamie Delano,75976178
Twentieth Century Fox Film Corporation,43000000,Rob Bowman,-18590278,Jennifer Garner,1,Mark Steven Johnson,24409722
Fox 2000 Pictures,28000000,James Mangold,91519402,Joaquin Phoenix,11,Johnny Cash,119519402
Metro-Goldwyn-Mayer (MGM),19000000,Andrew Douglas,46233369,Ryan Reynolds,4,Scott Kosar,65233369
Columbia Pictures Corporation,70000000,Andy Tennant,109495555,Will Smith,2,Kevin Bisch,179495555
Universal Pictures,207000000,Peter Jackson,11080025,Naomi Watts,12,Fran Walsh,218080025
Universal Pictures,26000000,Judd Apatow,83449237,Steve Carell,8,Judd Apatow,109449237
Regency Enterprises,120000000,Doug Liman,66336279,Brad Pitt,6,Simon Kinberg,186336279
Twisted Pictures,4000000,Darren Lynn Bousman,83039965,Donnie Wahlberg,10,Leigh Whannell,87039965
Samuel Goldwyn Films,1500000,Noah Baumbach,5862100,Owen Kline,12,Noah Baumbach,7362100
Lions Gate Films,7000000,Rob Zombie,10044981,Sid Haig,7,Rob Zombie,17044981
Warner Bros.,40000000,Tim Burton,13359111,Johnny Depp,9,Tim Burton,53359111
Walt Disney Pictures,35000000,Mike Mitchell,28946815,Kurt Russell,7,Paul Hernandez,63946815
DreamWorks,126000000,Michael Bay,-90181087,Scarlett Johansson,7,Caspian Tredwell-Owen,35818913
Gold Circle Films,15000000,Clare Kilner,16726995,Dermot Mulroney,2,Elizabeth Young,31726995
Universal Pictures,88000000,Ron Howard,-26350089,Russell Crowe,6,Cliff Hollingsworth,61649911
Universal Pictures,72000000,Sam Mendes,-9341780,Jake Gyllenhaal,11,William Broyles Jr.,62658220
DreamWorks,70000000,Steven Spielberg,-22596315,Eric Bana,1,Tony Kushner,47403685
Metro-Goldwyn-Mayer (MGM),53000000,F. Gary Gray,3046979,John Travolta,3,Elmore Leonard,56046979
Miramax,52000000,Florent-Emilio Siri,-17360061,Bruce Willis,3,Robert Crais,34639939
New Line Cinema,32000000,David Cronenberg,-506218,Viggo Mortensen,9,John Wagner,31493782
Twentieth Century Fox Film Corporation,100000000,Tim Story,54696080,Ioan Gruffudd,7,Mark Frost,154696080
BBC Films,15000000,Woody Allen,8089926,Scarlett Johansson,1,Woody Allen,23089926
Columbia Pictures Corporation,65000000,Jon Favreau,-35741131,Josh Hutcherson,11,Chris Van Allsburg,29258869
Universal Pictures,25000000,Kirk Jones,22144110,Emma Thompson,1,Emma Thompson,47144110
DreamWorks Animation,75000000,Eric Darnell,118595521,Chris Rock,5,Mark Burton,193595521
Warner Bros.,50000000,Jay Chandrasekhar,30270227,Seann William Scott,8,John O'Brien,80270227
Entertainment Manufacturing Company,50000000,Andrew Niccol,-25850368,Nicolas Cage,9,Andrew Niccol,24149632
Lions Gate Films,950000,David Slade,57962,Patrick Wilson,4,Brian Nelson,1007962
Touchstone Pictures,55000000,Robert Schwentke,34707299,Jodie Foster,9,Peter A. Dowling,89707299
Columbia Pictures Corporation,85000000,Rob Marshall,-27509492,Ziyi Zhang,12,Robin Swicord,57490508
Screen Gems,20000000,Scott Derrickson,55072454,Laura Linney,9,Paul Harris Boardman,75072454
New Line Cinema,30000000,Terrence Malick,-17287907,Colin Farrell,1,Terrence Malick,12712093
Warner Bros.,30000000,Jaume Collet-Serra,2064800,Chad Michael Murray,5,Charles Belden,32064800
Twentieth Century Fox Film Corporation,60000000,Adam Shankman,22571173,Steve Martin,12,Sam Harper,82571173
Paramount Pictures,45000000,John Singleton,29494381,Mark Wahlberg,8,David Elliot,74494381
Dimension Films,50000000,Robert Rodriguez,-10822316,Cayden Boyd,6,Robert Rodriguez,39177684
Warner Bros.,15000000,Shane Black,-10756244,Robert Downey Jr.,11,Brett Halliday,4243756
Eden Rock Media,3000000,Rob McKittrick,13124543,Ryan Reynolds,10,Rob McKittrick,16124543
Dimension Films,88000000,Terry Gilliam,-50083733,Matt Damon,8,Ehren Kruger,37916267
Paramount Pictures,62000000,Karyn Kusama,-36142013,Charlize Theron,12,Phil Hay,25857987
Alcon Entertainment,25000000,Ken Kwapis,14008741,Amber Tamblyn,6,Ann Brashares,39008741
Columbia Pictures Corporation,60000000,Lee Tamahori,-33126068,Ice Cube,4,Rich Wilkes,26873932
DreamWorks,26000000,Wes Craven,31891803,Rachel McAdams,8,Carl Ellsworth,57891803
Twentieth Century Fox Animation,75000000,Chris Wedge,53200012,Ewan McGregor,3,Ron Mita,128200012
DreamWorks,58000000,Mark Waters,-9681870,Reese Witherspoon,9,Peter Tolan,48318130
Bergman Lustig Productions,475000,Rian Johnson,1585589,Joseph Gordon-Levitt,4,Rian Johnson,2060589
Columbia Pictures,75000000,Martin Campbell,-28535977,Antonio Banderas,10,Roberto Orci,46464023
Coach Carter,30000000,Thomas Carter,37264877,Samuel L. Jackson,1,Mark Schwahn,67264877
Walt Disney Pictures,50000000,Angela Robinson,16023816,Lindsay Lohan,6,Thomas Lennon,66023816
Warner Bros.,70000000,Rob Reiner,-26999738,Jennifer Aniston,12,Ted Griffin,43000262
Walt Disney Pictures,56000000,Adam Shankman,57086868,Vin Diesel,3,Thomas Lennon,113086868
Twentieth Century Fox Film Corporation,30000000,John Polson,21100486,Robert De Niro,1,Ari Schlossberg,51100486
Australian Film Finance Corporation The,1000000,Greg McLean,15188180,Nathan Phillips,12,Greg McLean,16188180
Walt Disney Pictures,150000000,Mark Dindal,-14613335,Zach Braff,11,Mark Dindal,135386665
Columbia Pictures Corporation,25000000,Catherine Hardwicke,-13991568,Heath Ledger,6,Stacy Peralta,11008432
Di Bonaventura Pictures,22000000,Mikael Håfström,14024076,Clive Owen,11,Stuart Beattie,36024076
Universal Pictures,43000000,Iain Softley,4806295,Kate Hudson,8,Ehren Kruger,47806295
Columbia Pictures Corporation,50000000,John Stockwell,-31527637,Paul Walker,9,Matt Johnson,18472363
John Wells Productions,60000000,Andrzej Bartkowiak,-31968750,Karl Urban,10,Dave Callaham,28031250
BBC Films,7900000,Ol Parker,-7228760,Piper Perabo,5,Ol Parker,671240
EuropaCorp,32000000,Louis Leterrier,11095600,Jason Statham,9,Luc Besson,43095600
Universal Pictures,15000000,George A. Romero,5700082,John Leguizamo,6,George A. Romero,20700082
Sony Pictures Classics,7000000,Bennett Miller,21747570,Philip Seymour Hoffman,2,Dan Futterman,28747570
Universal Pictures,45000000,Susan Stroman,-25622273,Nathan Lane,12,Mel Brooks,19377727
Focus Features,10000000,Jim Jarmusch,3744960,Bill Murray,8,Jim Jarmusch,13744960
Paramount Pictures,130000000,Breck Eisner,-61328075,Matthew McConaughey,4,Clive Cussler,68671925
Room 9 Entertainment,6500000,Jason Reitman,18292061,Aaron Eckhart,4,Jason Reitman,24792061
Warner Bros.,50000000,Stephen Gaghan,824620,George Clooney,12,Stephen Gaghan,50824620
Andrea Sperling Productions,2000000,David Ayer,1337931,Christian Bale,11,David Ayer,3337931
Regency Enterprises,50000000,Marc Forster,-46373117,Ewan McGregor,10,David Benioff,3626883
The Weinstein Company,17500000,Cory Edwards,33886611,Anne Hathaway,1,Cory Edwards,51386611
The Family Stone,17000000,Thomas Bezucha,43062868,Dermot Mulroney,12,Thomas Bezucha,60062868
Mandalay Pictures,29000000,John Maybury,-22696238,Adrien Brody,3,Tom Bleecker,6303762
Paramount Pictures,45000000,Raja Gosnell,8412862,Dennis Quaid,11,Ron Burch,53412862
BET Pictures,5500000,Darren Grant,45133099,Kimberly Elise,2,Tyler Perry,50633099
Miramax,20000000,John Madden,-12475234,Gwyneth Paltrow,10,David Auburn,7524766
DreamWorks,50000000,Hideo Nakata,26231249,Naomi Watts,3,Ehren Kruger,76231249
UK Film Council,2000000,John Hillcoat,-99275,Ray Winstone,6,Nick Cave,1900725
New Line Cinema,50000000,Tony Scott,-39830798,Keira Knightley,10,Richard Kelly,10169202
New Line Cinema,84000000,Lawrence Guterman,-66981578,Jamie Kennedy,2,Lance Khazei,17018422
Touchstone Pictures,30000000,Nigel Cole,-8164216,Ashton Kutcher,4,Colin Patrick Lynch,21835784
New Line Cinema,60000000,Robert Luketic,22931301,Jennifer Lopez,5,Anya Kochoff,82931301
Touchstone Pictures,30000000,Walter Salles,-4526648,Jennifer Connelly,7,Kôji Suzuki,25473352
Cent Productions Inc.,40000000,Jim Sheridan,-9018150,50 Cent,11,Terence Winter,30981850
Screen Gems,30000000,Bruce Hunt,-14992009,Piper Perabo,8,Michael Steinberg,15007991
Recorded Picture Company (RPC),19300000,Terry Gilliam,-19233547,Jeff Bridges,8,Tony Grisoni,66453
Revolution Studios,18000000,Rupert Wainwright,11511112,Tom Welling,10,Cooper Layne,29511112
Warner Bros.,35000000,Niki Caro,-16675758,Charlize Theron,10,Michael Seitzman,18324242
OLC / Rights Entertainment,25000000,Roger Donaldson,-19871876,Anthony Hopkins,3,Roger Donaldson,5128124
Columbia Pictures Corporation,100000000,Dean Parisot,10332737,Jim Carrey,12,Judd Apatow,110332737
Paramount Pictures,57000000,Cameron Crowe,-30161611,Orlando Bloom,10,Cameron Crowe,26838389
Warner Independent Pictures (WIP),7500000,George Clooney,24001218,David Strathairn,11,George Clooney,31501218
Crunk Pictures,8000000,Craig Brewer,14201636,Terrence Howard,7,Craig Brewer,22201636
Columbia Pictures Corporation,22000000,Mike Bigelow,264487,Rob Schneider,8,Harris Goldberg,22264487
Columbia Pictures Corporation,85000000,Nora Ephron,-22747585,Nicole Kidman,6,Nora Ephron,62252415
Aardman Animations,30000000,Steve Box,26110897,Peter Sallis,10,Steve Box,56110897
Dimension Films,3200000,John Gulager,-3145444,Navi Rawat,1,Marcus Dunstan,54556
AITD Productions,20000000,Uwe Boll,-14821431,Christian Slater,1,Elan Mastai,5178569
EuropaCorp,15000000,Tommy Lee Jones,-9976725,Tommy Lee Jones,2,Guillermo Arriaga,5023275
Miramax,30000000,Lasse Hallström,-21413608,Jennifer Lopez,9,Mark Spragg,8586392
Castle Rock Entertainment,45000000,John Pasquin,3478006,Sandra Bullock,3,Marc Lawrence,48478006
EuropaCorp,45000000,Louis Leterrier,-20479108,Jet Li,5,Luc Besson,24520892
Universal Pictures,80000000,Sydney Pollack,-7291839,Nicole Kidman,4,Martin Stellman,72708161
Revolution Studios,32000000,Brian Levant,50674398,Ice Cube,1,Steven Gary Banks,82674398
Dimension Films,38000000,Wes Craven,-18702478,Christina Ricci,2,Kevin Williamson,19297522
Fox 2000 Pictures,30000000,Bobby Farrelly,12071069,Drew Barrymore,4,Lowell Ganz,42071069
Columbia Pictures Corporation,135000000,Rob Cohen,-102883254,Josh Lucas,7,W.D. Richter,32116746
Universal Pictures,45000000,Jesse Dylan,7580895,Will Ferrell,5,Leo Benvenuti,52580895
IFC Productions,1500000,Rebecca Miller,-787706,Daniel Day-Lewis,4,Rebecca Miller,712294
Andrea Sperling Productions,900000,Jamie Babbit,-518814,Camilla Belle,8,Abdi Nazemian,381186
Rogue Pictures,20000000,Jean-François Richet,-23927,Ethan Hawke,1,John Carpenter,19976073
Serendipity Point Films,25000000,Atom Egoyan,-24128473,Kevin Bacon,10,Atom Egoyan,871527
Columbia Pictures Corporation,35000000,Kevin Rodney Sullivan,33915888,Ashton Kutcher,3,William Rose,68915888
Boll Kino Beteiligungs GmbH & Co. KG,25000000,Uwe Boll,-22594580,Kristanna Loken,1,Guinevere Turner,2405420
Screen Gems,20000000,Stephen Kay,26752382,Barry Watson,2,Eric Kripke,46752382
Twentieth Century Fox Film Corporation,14000000,Wayne Wang,18645546,AnnaSophia Robb,2,Kate DiCamillo,32645546
REN-Mar Studios,2500000,Marcos Siega,-2194312,Evan Rachel Wood,6,Skander Halim,305688
Milkshake Films,10000000,Danny Cannon,-5719423,Kuno Becker,5,Mike Jefferies,4280577
Miramax,80000000,John Dahl,-69833498,Benjamin Bratt,8,William B. Breuer,10166502
Warner Bros.,30000000,Gary David Goldberg,13894863,Diane Lane,7,Claire Cook,43894863
Rogue Pictures,1000000,Jeff Wadlow,9047674,Julian Morris,9,Jeff Wadlow,10047674
Paramount Pictures,30000000,Richard Linklater,2868349,Billy Bob Thornton,7,Bill Lancaster,32868349
Belladonna Productions,1000000,Duncan Tucker,8015303,Felicity Huffman,3,Duncan Tucker,9015303
Twentieth Century Fox Film Corporation,33100000,Steve Carr,-16291664,Martin Lawrence,7,William Wolff,16808336
Revolution Studios,40000000,Stephen Herek,-20300294,Tommy Lee Jones,2,John J. McLaughlin,19699706
Universal Pictures,20000000,D.J. Caruso,2862049,Matthew McConaughey,10,Dan Gilroy,22862049
Tag Entertainment,16000000,Steve Boyum,-12898699,Steve Howey,8,Ken Solarz,3101301
Universal Pictures,25000000,Mark Rosman,-8752225,Hilary Duff,6,Michael McQuown,16247775
Warner Independent Pictures (WIP),7000000,Liev Schreiber,-5294405,Elijah Wood,10,Jonathan Safran Foer,1705595
Alcon Entertainment,30000000,Frederik Du Chau,19772522,Frankie Muniz,1,David Schmidt,49772522
Comedy Central Films,3500000,Paul Dinello,-1431677,Amy Sedaris,7,Stephen Colbert,2068323
Junebug Movie,1000000,Phil Morrison,1678691,Embeth Davidtz,9,Angus MacLachlan,2678691
Paramount Pictures,22000000,Gore Verbinski,-9517225,Nicolas Cage,10,Steve Conrad,12482775
Nord-Ouest Productions,22000000,Christian Carion,-20945639,Diane Kruger,5,Christian Carion,1054361
Zentropa Entertainments,14200000,Lars von Trier,-14121622,Bryce Dallas Howard,11,Lars von Trier,78378
Bob Yari Productions,4000000,Mike Mills,-2674927,Lou Taylor Pucci,10,Walter Kirn,1325073
Franchise Pictures,80000000,Peter Hyams,-78108179,Edward Burns,9,Ray Bradbury,1891821
Universal Pictures,10000000,Geoffrey Sax,46386759,Michael Keaton,1,Niall Johnson,56386759
Morgan Creek Productions,30000000,Paul Schrader,-29748505,Stellan Skarsgård,5,William Wisher,251495
Destination Films,4000000,Dave McKean,-3135041,Stephanie Leonidas,3,Neil Gaiman,864959
New Line Cinema,9000000,Mike Binder,9761993,Joan Allen,4,Mike Binder,18761993
Summit Entertainment,169000,Niall Johnson,1449957,Rowan Atkinson,10,Richard Russo,1618957
Allan Zeman Productions,14000000,Courtney Solomon,2298046,Donald Sutherland,5,Brent Monahan,16298046
IFC Films,2000000,Miranda July,1885134,John Hawkes,8,Miranda July,3885134
Manitoba Film and Video Production Tax Credit,3800000,Jeremy Haft,-3632277,Jenna Dewan Tatum,2,Jeffrey Reddick,167723
Pathé Pictures,20000000,Stephen Frears,-8965564,Judi Dench,2,David Rose,11034436
DreamWorks,32000000,John Gatins,701088,Kurt Russell,10,John Gatins,32701088
Merchant Ivory Productions,16000000,James Ivory,-14333738,Ralph Fiennes,6,Kazuo Ishiguro,1666262
Blackwater Films,1000000,Alexander Bulkley,-955215,Justin Chambers,8,Alexander Bulkley,44785
Vanguard Animation,35000000,Gary Chapman,-15552522,Ewan McGregor,8,George Webster,19447478
The UK Film & TV Production Company PLC,3000000,Gavin Hood,-87637,Presley Chweneyagae,3,Gavin Hood,2912363
El Camino Pictures,6800000,Arie Posin,-6750474,Jamie Bell,10,Arie Posin,49526
Stratus Film Co.,10000000,Richard Shepard,2594698,Pierce Brosnan,1,Richard Shepard,12594698
New Line Cinema,33000000,Les Mayfield,-24673965,Samuel L. Jackson,9,Jim Piddock,8326035
Lions Gate Films,7500000,Brett Leonard,-7356385,Jack Thompson,4,Steve Gerber,143615
Stratus Film Co.,3500000,Adam Rapp,-3398772,Ed Harris,6,Adam Rapp,101228
Shoreline Entertainment,2500000,Randall Miller,-2252859,Robert Carlyle,1,Randall Miller,247141
Lunar Films,12500000,Cédric Klapisch,-12176669,Romain Duris,6,Cédric Klapisch,323331
Mandragora,500000,Cristi Puiu,-420057,Doru Ana,9,Cristi Puiu,79943
Touchstone Pictures,40000000,Christopher Nolan,13089891,Christian Bale,10,Jonathan Nolan,53089891
Warner Bros.,90000000,Martin Scorsese,42384315,Leonardo DiCaprio,10,William Monahan,132384315
Warner Bros.,65000000,Zack Snyder,145614939,Gerard Butler,3,Zack Snyder,210614939
Walt Disney Pictures,225000000,Gore Verbinski,198315812,Johnny Depp,7,Ted Elliott,423315812
Warner Bros.,35000000,Darren Aronofsky,-24855990,Hugh Jackman,11,Darren Aronofsky,10144010
Universal Pictures,76000000,Alfonso Cuarón,-40447617,Julianne Moore,1,Alfonso Cuarón,35552383
Columbia Pictures,150000000,Martin Campbell,17445960,Daniel Craig,11,Neal Purvis,167445960
Icon Entertainment International,40000000,Mel Gibson,10866635,Gerardo Taracena,12,Mel Gibson,50866635
Fox 2000 Pictures,35000000,David Frankel,89740460,Anne Hathaway,6,Aline Brosh McKenna,124740460
Wiedemann & Berg Filmproduktion,2000000,Florian Henckel von Donnersmarck,9286112,Ulrich Mühe,3,Florian Henckel von Donnersmarck,11286112
Pixar Animation Studios,120000000,John Lasseter,124082982,Owen Wilson,6,John Lasseter,244082982
Silent Hill DCP Inc.,50000000,Christophe Gans,-3017368,Radha Mitchell,4,Roger Avary,46982632
Columbia Pictures Corporation,55000000,Gabriele Muccino,108566459,Will Smith,12,Steve Conrad,163566459
Fox Searchlight Pictures,8000000,Jonathan Dayton,51891098,Steve Carell,8,Michael Arndt,59891098
Hunting Lane Films,700000,Ryan Fleck,1994973,Ryan Gosling,9,Ryan Fleck,2694973
Craven-Maddalena Films,15000000,Alexandre Aja,26778863,Ted Levine,3,Wes Craven,41778863
Columbia Pictures,85000000,Nancy Meyers,-21775151,Kate Winslet,12,Nancy Meyers,63224849
DreamWorks,20000000,Andy Fickman,-17660265,Amanda Bynes,3,Ewan Leslie,2339735
Universal Pictures,85000000,Justin Lin,-22485585,Lucas Black,6,Chris Morgan,62514415
Columbia Pictures,125000000,Ron Howard,92536138,Tom Hanks,5,Akiva Goldsman,217536138
Columbia Pictures Corporation,40000000,Sofia Coppola,-24037529,Kirsten Dunst,10,Sofia Coppola,15962471
Warner Bros.,100000000,Edward Zwick,-42633738,Leonardo DiCaprio,12,Charles Leavitt,57366262
Fox 2000 Pictures,35000000,Ridley Scott,-27541731,Russell Crowe,11,Marc Klein,7458269
Universal Pictures,45000000,Spike Lee,43513495,Denzel Washington,3,Russell Gewirtz,88513495
Paramount Pictures,25000000,Alejandro González Iñárritu,9302837,Brad Pitt,11,Guillermo Arriaga,34302837
Twisted Pictures,10000000,Darren Lynn Bousman,70238724,Tobin Bell,10,Leigh Whannell,80238724
New Line Cinema,16000000,Jonathan Liebesman,23517763,Jordana Brewster,10,Sheldon Turner,39517763
Universal Pictures,17000000,Joe Carnahan,18662731,Jeremy Piven,1,Joe Carnahan,35662731
Bull's Eye Entertainment,16000000,Neil Burger,23868642,Edward Norton,9,Neil Burger,39868642
Metro-Goldwyn-Mayer (MGM),24000000,Sylvester Stallone,46270943,Sylvester Stallone,12,Sylvester Stallone,70270943
Twentieth Century Fox Film Corporation,210000000,Brett Ratner,24362462,Patrick Stewart,5,Simon Kinberg,234362462
Columbia Pictures Corporation,70000000,Frank Coraci,67355633,Adam Sandler,6,Steve Koren,137355633
Universal Pictures,52000000,Peyton Reed,66703275,Jennifer Aniston,6,Jeremy Garelick,118703275
Touchstone Pictures,75000000,Tony Scott,-10961384,Denzel Washington,11,Bill Marsilii,64038616
Touchstone Pictures,12000000,Anne Fletcher,53328121,Channing Tatum,8,Duane Adler,65328121
Universal Pictures,135000000,Michael Mann,-71549530,Colin Farrell,7,Michael Mann,63450470
Warner Bros.,209000000,Bryan Singer,-8918808,Brandon Routh,6,Michael Dougherty,200081192
Twentieth Century Fox Film Corporation,18000000,Betty Thomas,23011711,Jesse Metcalfe,7,Jeff Lowell,41011711
Columbia Pictures,72500000,Adam McKay,75713377,Will Ferrell,8,Will Ferrell,148213377
Paramount Pictures,150000000,J.J. Abrams,-15970199,Tom Cruise,5,Alex Kurtzman,134029801
Four by Two,18000000,Larry Charles,110505958,Sacha Baron Cohen,11,Sacha Baron Cohen,128505958
The Weinstein Company,27000000,Paul McGuigan,-4505513,Josh Hartnett,4,Jason Smilovic,22494487
Twentieth Century Fox Film Corporation,110000000,Shawn Levy,140863268,Ben Stiller,12,Robert Ben Garant,250863268
Columbia Pictures,75000000,Gil Kenan,-1338990,Mitchel Musso,7,Dan Harmon,73661010
Screen Gems,20000000,Renny Harlin,3292105,Steven Strait,9,J.S. Cardone,23292105
Warner Bros.,160000000,Wolfgang Petersen,-99325183,Richard Dreyfuss,5,Mark Protosevich,60674817
DreamWorks,70000000,Bill Condon,33365956,Beyoncé Knowles,12,Tom Eyen,103365956
Universal Pictures,23000000,Steve Pink,13323505,Justin Long,8,Adam Cooper,36323505
Paramount Classics,15000000,Craig Brewer,-5603130,Christina Ricci,3,Craig Brewer,9396870
Metro-Goldwyn-Mayer (MGM),70000000,Michael Caton-Jones,-64028664,Sharon Stone,3,Leora Barish,5971336
New Line Cinema,26000000,Todd Field,-20536981,Kate Winslet,2,Todd Field,5463019
Columbia Pictures,65000000,Barry Sonnenfeld,6726025,Robin Williams,4,Geoff Rodkey,71726025
Universal Pictures,90000000,Robert De Niro,-30047165,Matt Damon,12,Eric Roth,59952835
Warner Bros.,65000000,McG,-21454636,Matthew McConaughey,12,Jamie Linden,43545364
Fox 2000 Pictures,100000000,Stefen Fangmeier,-24969837,Ed Speleers,12,Peter Buchman,75030163
Warner Independent Pictures (WIP),8700000,Richard Linklater,-3198384,Keanu Reeves,7,Philip K. Dick,5501616
Fu Works,21000000,Paul Verhoeven,-16601608,Carice van Houten,5,Gerard Soeteman,4398392
Warner Bros.,70000000,M. Night Shyamalan,-27714831,Paul Giamatti,7,M. Night Shyamalan,42285169
THINKFilm,2000000,John Cameron Mitchell,-14708,Sook-Yin Lee,10,John Cameron Mitchell,1985292
DreamWorks,19000000,Clint Eastwood,-5243918,Ken Watanabe,2,Iris Yamashita,13756082
Lakeshore Entertainment,12000000,Mark Neveldine,15829874,Jason Statham,9,Mark Neveldine,27829874
WIP,19400000,John Curran,-11339513,Naomi Watts,1,Ron Nyswaner,8060487
Columbia Pictures,38000000,Marc Forster,2137776,Will Ferrell,11,Zach Helm,40137776
Paramount Pictures,63000000,Oliver Stone,7278893,Nicolas Cage,8,Andrea Berloff,70278893
Gold Circle Films,15500000,James Gunn,-7725270,Nathan Fillion,3,James Gunn,7774730
Warner Bros.,100000000,George Miller,98000317,Elijah Wood,11,George Miller,198000317
Walt Disney Pictures,40000000,Frank Marshall,41612565,Paul Walker,2,David DiGilio,81612565
Warner Bros.,40000000,Alejandro Agresti,12330111,Keanu Reeves,6,David Auburn,52330111
DreamWorks,90000000,Clint Eastwood,-56397624,Ryan Phillippe,10,William Broyles Jr.,33602376
DreamWorks Animation,80000000,Tim Johnson,75019340,Bruce Willis,5,Len Blum,155019340
Fox Searchlight Pictures,6000000,Kevin Macdonald,11605861,James McAvoy,1,Peter Morgan,17605861
Screen Gems,50000000,Len Wiseman,12318875,Kate Beckinsale,1,Danny McBride,62318875
Aardman Animations,149000000,David Bowers,-84334328,Hugh Jackman,11,Dick Clement,64665672
New Line Cinema,25000000,James Wong,29098051,Mary Elizabeth Winstead,2,Glen Morgan,54098051
Universal Pictures,15000000,Paul Greengrass,16567134,David Alan Basche,4,Paul Greengrass,31567134
Screen Gems,30000000,Kurt Wimmer,-11499034,Milla Jovovich,3,Kurt Wimmer,18500966
Metro-Goldwyn-Mayer (MGM),10000000,Werner Herzog,-4509577,Christian Bale,7,Werner Herzog,5490423
Paramount Pictures,32000000,Jared Hess,48197993,Jack Black,6,Jared Hess,80197993
Fox Searchlight Pictures,15000000,Richard Eyre,2508670,Cate Blanchett,1,Patrick Marber,17508670
New Line Cinema,33000000,David R. Ellis,1020814,Samuel L. Jackson,8,John Heffernan,34020814
Walt Disney Pictures,40000000,Ericson Core,17789574,Mark Wahlberg,8,Brad Gann,57789574
Fox 2000 Pictures,12000000,Elizabeth Allen Rosenbaum,6595716,Emma Roberts,3,John Quaintance,18595716
Warner Bros.,40000000,Neil LaBute,-16356469,Nicolas Cage,9,Neil LaBute,23643531
Twentieth Century Fox Film Corporation,20000000,John Bonito,-1156686,John Cena,10,Michelle Gallagher,18843314
Warner Bros.,17500000,Jay Chandrasekhar,1685184,Jay Chandrasekhar,8,Jay Chandrasekhar,19185184
Universal Pictures,50000000,Brian De Palma,-27481675,Josh Hartnett,9,Josh Friedman,22518325
Twentieth Century Fox Film Corporation,25000000,John Moore,29607383,Liev Schreiber,6,David Seltzer,54607383
Lions Gate Films,4000000,William Friedkin,3006708,Ashley Judd,5,Tracy Letts,7006708
New Regency Pictures,28000000,Donald Petrie,-10675256,Lindsay Lohan,5,I. Marlene King,17324744
Revolution Studios,33000000,Dennis Dugan,24651794,David Spade,4,Allen Covert,57651794
Dimension Films,45000000,David Zucker,45710620,Anna Faris,4,Craig Mazin,90710620
Paramount Pictures,50000000,Tom Dey,38715192,Matthew McConaughey,3,Tom J. Astle,88715192
BBC Films,4000000,Woody Allen,6525717,Scarlett Johansson,7,Woody Allen,10525717
Fox Atomic,10000000,John Stockwell,-2974197,Josh Duhamel,12,Michael Arlen Ross,7025803
Constantin Film,21000000,Corey Yuen,-20519686,Jaime Pressly,6,J.F. Lawton,480314
Touchstone Pictures,70000000,Andrew Davis,-14988268,Kevin Costner,9,Ron L. Brinkerhoff,55011732
Screen Gems,15000000,Simon West,32860214,Camilla Belle,2,Jake Wade Wall,47860214
Metro-Goldwyn-Mayer (MGM),65000000,Shawn Levy,17226474,Steve Martin,2,Len Blum,82226474
DEJ Productions,10000000,Victor Salva,-6039586,Scott Mechlowicz,6,Kevin Bernhardt,3960414
No Matter Pictures,1000000,Goran Dukic,-683004,Patrick Fugit,11,Goran Dukic,316996
Revolution Studios,35000000,Peter Hewitt,-23368755,Tim Allen,8,Adam Rifkin,11631245
Summit Entertainment,15000000,Mark Palansky,-4988726,Christina Ricci,2,Leslie Caveny,10011274
Columbia Pictures Corporation,55000000,Steven Zaillian,-47778542,Sean Penn,9,Steven Zaillian,7221458
New Regency Pictures,20000000,Aaron Seltzer,28548426,Alyson Hannigan,2,Jason Friedberg,48548426
Victoires International,13000000,Olivier Assayas,-8142624,Juliette Binoche,6,Tristan Carné,4857376
Twentieth Century Fox Animation,80000000,Carlos Saldanha,115330621,Ray Romano,3,Peter Gaulke,195330621
The Weinstein Company,5000000,Kevin Smith,19138847,Brian O'Halloran,7,Kevin Smith,24138847
Revolution Studios,64000000,Keenen Ivory Wayans,-5354948,Shawn Wayans,7,Keenen Ivory Wayans,58645052
New Line Cinema,17000000,Wayne Kramer,-10144863,Paul Walker,2,Wayne Kramer,6855137
Universal Pictures,17000000,Richard Kelly,-16724620,Dwayne Johnson,12,Richard Kelly,275380
Samuelson Productions,40000000,Geoffrey Sax,-39347474,Alex Pettyfer,10,Anthony Horowitz,652526
The Weinstein Company,20000000,Jim Sonzero,259297,Kristen Bell,8,Wes Craven,20259297
Regency Enterprises,30000000,Ivan Reitman,-7469705,Uma Thurman,7,Don Payne,22530295
Focus Features,28000000,Allen Coulter,-13584778,Adrien Brody,9,Paul Bernbaum,14415222
Columbia Pictures Industries,30000000,Phil Joanou,8432823,Dwayne Johnson,9,Jeff Maguire,38432823
EuropaCorp,86000000,Luc Besson,-70867237,Freddie Highmore,1,Céline Garcia,15132763
Hollywood Pictures,9000000,William Brent Bell,14086480,Jon Foster,3,William Brent Bell,23086480
Columbia Pictures,85000000,Roger Allers,105259,Ashton Kutcher,9,Steve Bencich,85105259
ArieScope Pictures,1500000,Adam Green,-1344127,Kane Hodder,4,Adam Green,155873
Dimension Films,9000000,Glen Morgan,7235293,Michelle Trachtenberg,12,Glen Morgan,16235293
Millennium Films,18000000,Todd Robinson,-17811435,John Travolta,7,Todd Robinson,188565
Alcon Entertainment,52000000,Richard Donner,-15116461,Bruce Willis,3,Richard Wenk,36883539
Warner Bros.,50000000,Richard Loncraine,-1248811,Harrison Ford,2,Joe Forte,48751189
Universal Pictures,54000000,Anthony Russo,21628110,Kate Hudson,7,Michael LeSieur,75628110
Electric Entertainment,60000000,Tony Bill,-46917712,James Franco,9,Phil Sears,13082288
Columbia Pictures Corporation,20000000,Takashi Shimizu,19143839,Amber Tamblyn,10,Stephen Susco,39143839
Twentieth Century Fox Film Corporation,60000000,Clark Johnson,-23719303,Michael Douglas,4,George Nolfi,36280697
Big Easy Pictures,1000000,Katherine Brooks,100000,Erin Kelly,5,Katherine Brooks,1100000
Arc Productions,35000000,Colin Brady,-20477573,Jake T. Austin,9,Robert Kurtz,14522427
Beijing New Picture Film Co.,45000000,Yimou Zhang,-38433227,Yun-Fat Chow,1,Zhi-Hong Bian,6566773
Carmel Entertainment,100000,Alex Kendrick,10078331,Alex Kendrick,9,Alex Kendrick,10178331
Plan B Entertainment,12000000,Ryan Murphy,-5245102,Joseph Cross,10,Ryan Murphy,6754898
Imagine Entertainment,50000000,Matthew O'Callaghan,8640119,Will Ferrell,2,Ken Kaufman,58640119
New Line Cinema,30000000,Liz Friedlander,4742066,Antonio Banderas,4,Dianne Houston,34742066
Twentieth Century Fox Film Corporation,40000000,John Whitesell,30165972,Martin Lawrence,1,Don Rhymer,70165972
Walt Disney Pictures,12000000,Michael Lembeck,72500122,Tim Allen,11,Ed Decter,84500122
The Weinstein Company,14000000,Emilio Estevez,-2757199,Anthony Hopkins,11,Emilio Estevez,11242801
Phoenix Pictures,30000000,Chris Noonan,-27024351,Renée Zellweger,3,Richard Maltby Jr.,2975649
The Weinstein Company,7000000,George Hickenlooper,-5338536,Sienna Miller,2,Captain Mauzner,1661464
Lions Gate Films,6000000,Tyler Perry,57257940,Tyler Perry,2,Tyler Perry,63257940
World Wrestling Entertainment (WWE),8000000,Gregory Dark,7032800,Glenn Jacobs,5,Dan Madigan,15032800
The Saul Zaentz Company,50000000,Milos Forman,-48999955,Javier Bardem,1,Milos Forman,1000045
Paramount Pictures,51000000,Steve Oedekerk,21779000,Kevin James,8,Steve Oedekerk,72779000
Edward R. Pressman Film,16800000,Steven Shainberg,-16579086,Nicole Kidman,3,Erin Cressida Wilson,220914
Yari Film Group Releasing,13000000,Sidney Lumet,-11826327,Vin Diesel,3,Sidney Lumet,1173673
Dimension Films,20000000,Todd Phillips,-2196204,Billy Bob Thornton,9,Todd Phillips,17803796
Lionsgate,12000000,Greg Coolidge,16435406,Jessica Simpson,10,Don Calame,28435406
Luna Pictures,500000,Todd Stephens,154132,Michael Carbonaro,5,Tim Kaltenecker,654132
This Is That Productions,6500000,Nicole Holofcener,6867101,Jennifer Aniston,4,Nicole Holofcener,13367101
Partizan Films,6000000,Michel Gondry,-1336191,Gael García Bernal,9,Michel Gondry,4663809
Twentieth Century Fox Film Corporation,60000000,Tim Hill,-31573253,Breckin Meyer,6,Joel Cohen,28426747
Lakeshore Entertainment,20000000,Tony Goldwyn,-8403857,Zach Braff,9,Paul Haggis,11596143
Rick Lashbrook Films,3700000,Simon Brand,-3555603,Jim Caviezel,8,Matthew Waynee,144397
Warner Bros.,50000000,John A. Davis,-21857465,Paul Giamatti,7,John A. Davis,28142535
Gener8Xion Entertainment,20000000,Michael O. Sajbel,-6604039,Tiffany Dupont,10,Stephan Blinn,13395961
Universal Pictures,17000000,Paul Weitz,-9808170,Hugh Grant,4,Paul Weitz,7191830
Last Holiday Productions,45000000,Wayne Wang,-6639805,Queen Latifah,1,Jeffrey Price,38360195
C.O.R.E. Feature Animation,80000000,Steve 'Spaz' Williams,-42615954,Kiefer Sutherland,4,Ed Decter,37384046
Warner Independent Pictures (WIP),13000000,Douglas McGrath,-11849597,Toby Jones,10,Douglas McGrath,1150403
Touchstone Pictures,26000000,Justin Lin,-8872008,James Franco,1,David Collard,17127992
Warner Bros.,13000000,Michael Polish,-2003560,Billy Bob Thornton,2,Mark Polish,10996440
Universal Pictures,20000000,Barry Levinson,17442180,Robin Williams,10,Barry Levinson,37442180
Icon Productions,18000000,David Von Ancken,-17581704,Pierce Brosnan,1,David Von Ancken,418296
Poultry Productions LLC,500000,Lloyd Kaufman,-477000,Jason Yachanin,7,Gabriel Friedman,23000
Sunset Gower Studios,32000000,Steven Soderbergh,-30691304,George Clooney,1,Paul Attanasio,1308696
Fox 2000 Pictures,15000000,Michael Mayer,5998709,Alison Lohman,10,Mark Rosenthal,20998709
Warner Bros.,26000000,Paul Feig,-9352616,Dyllan Christopher,12,Jacob Meszaros,16647384
Lions Gate Films,8000000,Andrew Currie,-7701890,Kesun Loder,3,Robert Chomiak,298110
DreamWorks,150000000,Michael Bay,169071806,Shia LaBeouf,7,Roberto Orci,319071806
Paramount Vantage,25000000,Ethan Coen,49283625,Tommy Lee Jones,11,Joel Coen,74283625
Paramount Pictures,65000000,David Fincher,-31919916,Jake Gyllenhaal,3,James Vanderbilt,33080084
Paramount Pictures,70000000,Matthew Vaughn,-31365062,Charlie Cox,8,Jane Goldman,38634938
Warner Bros.,150000000,David Yates,142004738,Daniel Radcliffe,7,Michael Goldenberg,292004738
Paramount Pictures,61000000,Antoine Fuqua,-13996418,Mark Wahlberg,3,Jonathan Lemkin,47003582
Paramount Vantage,25000000,Paul Thomas Anderson,15222514,Daniel Day-Lewis,1,Paul Thomas Anderson,40222514
Paramount Vantage,15000000,Sean Penn,3352454,Emile Hirsch,10,Sean Penn,18352454
Dimension Films,18000000,Frank Darabont,7593755,Thomas Jane,11,Frank Darabont,25593755
LivePlanet,19000000,Ben Affleck,1300218,Morgan Freeman,10,Ben Affleck,20300218
Walt Disney Pictures,300000000,Gore Verbinski,9420425,Johnny Depp,5,Ted Elliott,309420425
Columbia Pictures,20000000,Greg Mottola,101463226,Michael Cera,8,Seth Rogen,121463226
Warner Bros.,150000000,Francis Lawrence,106386216,Will Smith,12,Mark Protosevich,256386216
Warner Bros.,30000000,Kirsten Sheridan,1655091,Freddie Highmore,11,Nick Castle,31655091
Universal Pictures,30000000,Joe Wright,20927067,Keira Knightley,1,Ian McEwan,50927067
Columbia Pictures,258000000,Sam Raimi,78530303,Tobey Maguire,5,Sam Raimi,336530303
Dimension Films,15000000,Rob Zombie,43272029,Scout Taylor-Compton,8,Rob Zombie,58272029
New Line Cinema,75000000,Adam Shankman,43871849,John Travolta,7,Leslie Dixon,118871849
Pixar Animation Studios,150000000,Brad Bird,56445654,Brad Garrett,6,Brad Bird,206445654
Warner Bros.,30000000,Andrew Dominik,-26095018,Brad Pitt,10,Andrew Dominik,3904982
Fox Searchlight Pictures,7500000,Jason Reitman,135995265,Ellen Page,12,Diablo Cody,143495265
Celluloid Dreams,15000000,Michael Haneke,-13705360,Naomi Watts,9,Michael Haneke,1294640
Walt Disney Pictures,85000000,Kevin Lima,42807262,Amy Adams,11,Bill Kelly,127807262
New Line Cinema,180000000,Chris Weitz,-109892272,Nicole Kidman,12,Chris Weitz,70107728
Universal Pictures,100000000,Ridley Scott,30164645,Denzel Washington,11,Steven Zaillian,130164645
DreamWorks,50000000,Tim Burton,2898073,Johnny Depp,12,John Logan,52898073
Universal Pictures,110000000,Paul Greengrass,117471070,Matt Damon,8,Tony Gilroy,227471070
Paramount Pictures,150000000,Robert Zemeckis,-67838031,Ray Winstone,11,Neil Gaiman,82161969
Fox Atomic,15000000,Juan Carlos Fresnadillo,13638916,Jeremy Renner,5,Rowan Joffe,28638916
Alcon Entertainment,30000000,Richard LaGravenese,23695808,Hilary Swank,12,Richard LaGravenese,53695808
Dimension Films,25000000,Mikael Håfström,46985628,John Cusack,6,Matt Greenberg,71985628
Universal Pictures,30000000,Judd Apatow,118734225,Seth Rogen,6,Judd Apatow,148734225
Twentieth Century Fox Film Corporation,24000000,Xavier Gens,15687694,Timothy Olyphant,11,Skip Woods,39687694
Twentieth Century Fox Film Corporation,110000000,Len Wiseman,24529403,Bruce Willis,6,Mark Bomback,134529403
Revolution Studios,45000000,Julie Taymor,-20656327,Evan Rachel Wood,10,Dick Clement,24343673
Dimension Films,53000000,Robert Rodriguez,-27968963,Kurt Russell,4,Robert Rodriguez,25031037
Walden Media,17000000,Gabor Csupo,65272442,Josh Hutcherson,2,Jeff Stockwell,82272442
Columbia Pictures Corporation,110000000,Mark Steven Johnson,5802596,Nicolas Cage,2,Mark Steven Johnson,115802596
Fox Searchlight Pictures,17500000,Wes Anderson,-5597285,Owen Wilson,10,Wes Anderson,11902715
Lionsgate,10000000,Eli Roth,7609452,Lauren German,6,Eli Roth,17609452
DreamWorks,20000000,D.J. Caruso,60209692,Shia LaBeouf,4,Christopher Landon,80209692
New Line Cinema,32000000,Joel Schumacher,3193167,Jim Carrey,2,Fernley Phillips,35193167
Scott Rudin Productions,10000000,Noah Baumbach,-8040580,Nicole Kidman,12,Noah Baumbach,1959420
New Line Cinema,140000000,Brett Ratner,125968,Jackie Chan,8,Jeff Nathanson,140125968
Lionsgate,55000000,James Mangold,-1393084,Russell Crowe,9,Halsted Welles,53606916
DreamWorks Animation,160000000,Chris Miller,160706665,Mike Myers,5,Jeffrey Price,320706665
Universal Pictures,175000000,Tom Shadyac,-74537702,Steve Carell,6,Steve Oedekerk,100462298
Metro-Goldwyn-Mayer (MGM),12000000,Craig Gillespie,-6027116,Ryan Gosling,11,Nancy Oliver,5972884
Twentieth Century Fox Film Corporation,40000000,Colin Strause,1797066,Reiko Aylesworth,12,Shane Salerno,41797066
Universal Pictures,20000000,James Wan,-3190924,Ryan Kwanten,3,Leigh Whannell,16809076
Columbia Pictures,32000000,David Slade,7568996,Josh Hartnett,10,Steve Niles,39568996
Twisted Pictures,10000000,Darren Lynn Bousman,53300095,Tobin Bell,10,Patrick Melton,63300095
Warner Bros.,85000000,Steven Soderbergh,32154724,George Clooney,6,Brian Koppelman,117154724
DreamWorks Animation,150000000,Simon J. Smith,-23368723,Jerry Seinfeld,11,Jerry Seinfeld,126631277
Paramount Pictures,21000000,Richard LaGravenese,15605602,Hilary Swank,1,Richard LaGravenese,36605602
Warner Bros.,45000000,Rob Reiner,48466502,Jack Nicholson,1,Justin Zackham,93466502
DreamWorks,60000000,Bobby Farrelly,-23212743,Ben Stiller,10,Scot Armstrong,36787257
Solana Films,15000,Oren Peli,107903810,Katie Featherston,10,Oren Peli,107918810
Metro-Goldwyn-Mayer (MGM),20000000,Bruce A. Evans,8476219,Kevin Costner,6,Bruce A. Evans,28476219
Twentieth Century Fox Film Corporation,75000000,David Silverman,108135014,Dan Castellaneta,7,James L. Brooks,183135014
Universal Pictures,75000000,Mike Nichols,-8338905,Tom Hanks,12,Aaron Sorkin,66661095
Young Hannibal Productions,50000000,Peter Webber,-22329014,Gaspard Ulliel,2,Thomas Harris,27670986
Walt Disney Pictures,22000000,Andy Fickman,68648202,Dwayne Johnson,9,Nichole Millard,90648202
Universal Pictures,85000000,Dennis Dugan,35059556,Adam Sandler,7,Barry Fanaro,120059556
Constantin Film,45000000,Russell Mulcahy,5648679,Milla Jovovich,9,Paul W.S. Anderson,50648679
Twentieth Century Fox Film Corporation,130000000,Tim Story,1921738,Ioan Gruffudd,6,Don Payne,131921738
Paramount Pictures,70000000,Lee Tamahori,-51788987,Nicolas Cage,4,Gary Goldman,18211013
Touchstone Pictures,25000000,Peter Hedges,22642963,Steve Carell,10,Pierce Gardner,47642963
Sidney Kimmel Entertainment,9000000,Frank Oz,-420316,Matthew Macfadyen,9,Dean Craig,8579684
New Line Cinema,39000000,Michael Davis,-26192861,Clive Owen,9,Michael Davis,12807139
Walt Disney Pictures,130000000,Jon Turteltaub,89964115,Nicolas Cage,12,Marianne Wibberley,219964115
Lionsgate,25000000,Mark Helfrich,9925283,Dane Cook,9,Josh Stolberg,34925283
Samuels Media,25000000,Tony Gilroy,24033882,George Clooney,10,Tony Gilroy,49033882
DreamWorks,61000000,Josh Gordon,57594548,Will Ferrell,3,Jeff Cox,118594548
Dino De Laurentiis Company,35000000,Doug Lefler,-29067940,Colin Firth,8,Jez Butterworth,5932060
DreamWorks,60000000,Brian Robbins,35673607,Eddie Murphy,2,Eddie Murphy,95673607
Killer Films,20000000,Todd Haynes,-15982391,Christian Bale,12,Todd Haynes,4017609
Walt Disney Animation Studios,150000000,Stephen J. Anderson,-52177829,Daniel Hansen,3,Jon Bernstein,97822171
Twentieth Century Fox Film Corporation,20000000,James Wan,-10474724,Kevin Bacon,8,Ian Mackenzie Jeffers,9525276
Universal Pictures,25000000,Steve Bendelack,8302167,Rowan Atkinson,8,Rowan Atkinson,33302167
Zazen Produções,4000000,José Padilha,-3991940,Wagner Moura,5,André Batista,8060
Fox 2000 Pictures,60000000,Tim Hill,157326974,Jason Lee,12,Jon Vitti,217326974
Avi Arad & Associates,20000000,Sean McNamara,-9994466,Skyler Shaye,8,Susan Estelle Jansen,10005534
Regency Enterprises,20000000,Jason Friedberg,19739367,Kal Penn,1,Jason Friedberg,39739367
Fox Atomic,15000000,Martin Weisz,5804166,Daniella Alonso,3,Wes Craven,20804166
Warner Bros.,80000000,Oliver Hirschbiegel,-64928486,Nicole Kidman,8,David Kajganich,15071514
Capitol Films,18000000,Sidney Lumet,-10916975,Philip Seymour Hoffman,10,Kelly Masterson,7083025
Castle Rock Entertainment,40000000,Marc Lawrence,10572589,Hugh Grant,2,Marc Lawrence,50572589
Universal Pictures,55000000,Shekhar Kapur,-38714760,Cate Blanchett,10,William Nicholson,16285240
The Weinstein Company,8600000,Joby Harold,5777198,Hayden Christensen,11,Joby Harold,14377198
Apatow Productions,35000000,Jake Kasdan,-16682849,John C. Reilly,12,Judd Apatow,18317151
Karbo Vantas Entertainment,2600000,Nacho Vigalondo,-2561892,Karra Elejalde,2,Nacho Vigalondo,38108
Universal Pictures,70000000,Peter Berg,-22463222,Jamie Foxx,9,Matthew Michael Carnahan,47536778
Relativity Media,20000000,Mike Binder,-338013,Adam Sandler,3,Mike Binder,19661987
Focus Features,10000000,Dave Meyers,6472961,Sean Bean,1,Eric Red,16472961
Metro-Goldwyn-Mayer (MGM),35000000,Robert Redford,-20001930,Tom Cruise,11,Matthew Michael Carnahan,14998070
Screen Gems,19000000,Nimród Antal,363565,Kate Beckinsale,4,Mark L. Smith,19363565
DreamWorks,20000000,Marc Forster,-4199922,Khalid Abdalla,1,David Benioff,15800078
Night and Day Pictures,1500000,Adrienne Shelly,17567631,Keri Russell,5,Adrienne Shelly,19067631
Anonymous Content,27500000,Gavin Hood,-17763955,Reese Witherspoon,10,Kelley Sane,9736045
Revolution Studios,60795000,James Foley,-36810051,Halle Berry,4,Todd Komarnicki,23984949
Columbia Pictures,21000000,James Gray,7563179,Joaquin Phoenix,10,James Gray,28563179
Millennium Films,30000000,Jon Avnet,-13069116,Al Pacino,4,Gary Scott Thompson,16930884
HanWay Films,16500000,Julian Jarrold,2170946,Anne Hathaway,8,Jane Austen,18670946
TriStar Pictures,20000000,Mennan Yapo,27852604,Sandra Bullock,3,Bill Kelly,47852604
American Zoetrope,5000000,Francis Ford Coppola,-4755603,Tim Roth,10,Mircea Eliade,244397
Columbia Pictures,100000000,Ash Brannon,-41132306,Shia LaBeouf,6,Don Rhymer,58867694
Lionsgate,25000000,Philip G. Atwell,-2533006,Jet Li,8,Lee Anthony Smith,22466994
Warner Bros.,70000000,Neil Jordan,-33206196,Jodie Foster,9,Roderick Taylor,36793804
The Weinstein Company,20000000,Shari Springer Berman,5925170,Scarlett Johansson,8,Emma McLaughlin,25925170
Hollywood Pictures,30000000,David S. Goyer,-9431681,Justin Chatwin,4,Mick Davis,20568319
Imagi Animation Studios,34000000,Kevin Munroe,20149098,Patrick Stewart,3,Kevin Munroe,54149098
360 Pictures,12000000,Chris Sivertson,-4501284,Lindsay Lohan,7,Jeff Hammond,7498716
Celluloid Dreams,4600000,Tom Kalin,-4165583,Julianne Moore,1,Howard A. Rodman,434417
Twentieth Century Fox Film Corporation,20000000,Marcus Nispel,-9767919,Karl Urban,4,Laeta Kalogridis,10232081
New Line Cinema,22000000,Craig Gillespie,3628629,Billy Bob Thornton,9,Michael Carnes,25628629
New Line Cinema,27000000,Menno Meyjes,-19513094,John Cusack,11,Seth Bass,7486906
Castle Rock Entertainment,28000000,Scott Hicks,15107979,Catherine Zeta-Jones,7,Carol Fuchs,43107979
Morgan Creek Productions,16500000,Joe Nussbaum,-4607585,Amanda Bynes,9,Chad Gomez Creasey,11892415
Warner Bros.,20000000,Andrew Fleming,5612520,Emma Roberts,6,Andrew Fleming,25612520
Boll Kino Beteiligungs GmbH & Co. KG,60000000,Uwe Boll,-55464883,Jason Statham,1,Doug Taylor,4535117
New Line Cinema,45000000,Mike Newell,-40392392,Javier Bardem,11,Ronald Harwood,4607608
2.4.7. Films,7300000,Vincent Paronnaud,-2856597,Chiara Mastroianni,2,Marjane Satrapi,4443403
Warner Bros.,40000000,Stephen Hopkins,-14882502,Hilary Swank,4,Carey Hayes,25117498
Castle Rock Entertainment,10000000,Jon Kasdan,1043445,Adam Brody,4,Jon Kasdan,11043445
Harpo Films,15000000,Denzel Washington,15226144,Denzel Washington,12,Robert Eisele,30226144
Block 2 Pictures,10000000,Kar-Wai Wong,-9133222,Norah Jones,4,Kar-Wai Wong,866778
Avenue Pictures,5000000,Daniel Waters,-4976437,Robert Wisdom,2,Daniel Waters,23563
Captivity Productions,17000000,Roland Joffé,-14373200,Elisha Cuthbert,7,Larry Cohen,2626800
P2 Productions,8000000,Franck Khalfoun,-4007661,Rachel Nichols,11,Alexandre Aja,3992339
Mandate Pictures,65000000,Zach Helm,-32938445,Natalie Portman,11,Zach Helm,32061555
Rhombus Media,20000000,François Girard,-18896925,Michael Pitt,9,Alessandro Baricco,1103075
Lionsgate,12000000,Marco Kreuzpaintner,-11785798,Kevin Kline,4,Jose Rivera,214202
Blueprint Pictures,6000000,Gregory Jacobs,-5979854,Emily Blunt,8,Joe Gangemi,20146
Artfire Films,2000000,George A. Romero,-1041039,Michelle Morgan,2,George A. Romero,958961
Screen Gems,16000000,Danny Pang,19374833,Dylan McDermott,2,Mark Wheaton,35374833
Warner Bros.,35000000,Ken Kwapis,8799818,Mandy Moore,7,Kim Barker,43799818
Metro-Goldwyn-Mayer (MGM),12000000,Jon Poll,-8049706,Anton Yelchin,2,Gustin Nash,3950294
Haishang Films,15000000,Ang Lee,-10397488,Tony Chiu-Wai Leung,10,Eileen Chang,4602512
Revolution Studios,40000000,Jay Russell,412817,Emily Watson,12,Robert Nelson Jacobs,40412817
Miramax,16000000,Scott Frank,-11399415,Joseph Gordon-Levitt,3,Scott Frank,4600585
Rainforest Films,14000000,Sylvain White,47356221,Columbus Short,1,Robert Adetuyi,61356221
Morgan Creek Productions,20000000,Garry Marshall,-1117120,Jane Fonda,5,Mark Andrus,18882880
Warner Bros.,100000000,David Dobkin,-27993223,Vince Vaughn,11,Dan Fogelman,72006777
Lions Gate Films,10000000,Tyler Perry,21339647,Gabrielle Union,2,Tyler Perry,31339647
A-Team,3800000,Takashi Miike,-3751966,Hideaki Itô,9,Takashi Miike,48034
Revolution Studios,28000000,Steve Carr,21631958,Ice Cube,4,Hank Nelken,49631958
DreamWorks,16000000,Susanne Bier,-12712685,Halle Berry,10,Allan Loeb,3287315
Intermedia,25000000,Richard Shepard,-24030131,Richard Gere,9,Richard Shepard,969869
CTB Film Company,20000000,Sergei Bodrov,-14298357,Tadanobu Asano,7,Arif Aliev,5701643
Paramount Vantage,16000000,Michael Winterbottom,-6823213,Angelina Jolie,6,John Orloff,9176787
Fox Atomic,20000000,Tom Brady,-6650749,David Koechner,10,Ed Yeager,13349251
Magnolia Pictures,20000000,Michael Radford,-18799766,Demi Moore,3,Edward Anderson,1200234
Focus Features,11000000,Terry George,-10878006,Joaquin Phoenix,8,John Burnham Schwartz,121994
Deerjen Films,3750000,Deborah Kampmeier,-3621908,Dakota Fanning,1,Deborah Kampmeier,128092
Rifkin-Eberts,2600000,Tony Giglio,-2550000,Josh Randall,5,Dan Kay,50000
Lions Gate Films,15000000,Tyler Perry,40184721,Tyler Perry,10,Tyler Perry,55184721
Facilitator Films,13000000,Preston A. Whitmore II,36121934,Regina King,11,Preston A. Whitmore II,49121934
Metro-Goldwyn-Mayer (MGM),15000000,Katja von Garnier,-11474839,Agnes Bruckner,1,Ehren Kruger,3525161
Odyssey Entertainment,3500000,Helen Hunt,235303,Helen Hunt,5,Alice Arlen,3735303
Hyde Park Entertainment,8000000,Stuart Townsend,-7776463,André Benjamin,5,Stuart Townsend,223537
Australian Film Finance Corporation (AFFC),4000000,Rod Hardy,-3953526,Daniel Radcliffe,11,Ronald Kinnoch,46474
Medusa Film,3500000,Dario Argento,-3441331,Asia Argento,2,Jace Anderson,58669
NALA Films,10000000,Jieho Lee,-9974225,Brendan Fraser,10,Jieho Lee,25775
Showbox Entertainment,35000000,Hyung-rae Shim,-24022279,Jason Behr,9,Hyung-rae Shim,10977721
B&W; Films,6000000,Jeffrey Blitz,-5287609,Reece Thompson,9,Jeffrey Blitz,712391
Chicago Pictures,26000000,Andy Cheng,-19122867,Nathan Phillips,4,Robert Foreman,6877133
Twentieth Century Fox Film Corporation,45000000,David L. Cunningham,-36208262,Alexander Ludwig,10,John Hodge,8791738
Twentieth Century Fox Film Corporation,10000000,Robert Ben Garant,10342161,Thomas Lennon,2,Robert Ben Garant,20342161
Warner Bros.,55000000,Curtis Hanson,-49244714,Eric Bana,5,Eric Roth,5755286
Warner Bros.,185000000,Christopher Nolan,349858444,Christian Bale,7,Jonathan Nolan,534858444
Summit Entertainment,37000000,Catherine Hardwicke,154465414,Kristen Stewart,11,Melissa Rosenberg,191465414
Universal Pictures,85000000,Guillermo del Toro,-9245330,Ron Perlman,7,Guillermo del Toro,75754670
Columbia Pictures,25000000,Fred Wolf,23237389,Anna Faris,8,Karen McCullah,48237389
Universal Pictures,52000000,Phyllida Lloyd,92130063,Meryl Streep,7,Catherine Johnson,144130063
Rogue Pictures,10000000,Bryan Bertino,42597610,Scott Speedman,5,Bryan Bertino,52597610
DreamWorks,92000000,Ben Stiller,18515313,Ben Stiller,8,Justin Theroux,110515313
Paramount Pictures,140000000,Jon Favreau,178412101,Robert Downey Jr.,5,Mark Fergus,318412101
EuropaCorp,25000000,Pierre Morel,120000989,Liam Neeson,1,Luc Besson,145000989
Warner Bros.,150000000,David Fincher,-22490674,Brad Pitt,12,Eric Roth,127509326
Warner Bros.,18000000,Guy Ritchie,-12305599,Gerard Butler,10,Guy Ritchie,5694401
Wild Bunch,6000000,Darren Aronofsky,20236603,Mickey Rourke,1,Robert D. Siegel,26236603
Universal Pictures,75000000,Timur Bekmambetov,59508551,Angelina Jolie,6,Michael Brandt,134508551
Warner Bros.,15000000,Danny Boyle,126319928,Dev Patel,12,Simon Beaufoy,141319928
FortyFour Studios,180000000,Andrew Stanton,43808164,Ben Burtt,6,Andrew Stanton,223808164
Universal Pictures,150000000,Louis Leterrier,-15481610,Edward Norton,6,Zak Penn,134518390
New Line Cinema,65000000,Michael Patrick King,87647258,Sarah Jessica Parker,5,Michael Patrick King,152647258
Blueprint Pictures,15000000,Martin McDonagh,-7242870,Colin Farrell,2,Martin McDonagh,7757130
Columbia Pictures,65000000,Adam McKay,35468793,Will Ferrell,7,Will Ferrell,100468793
Matten Productions,33000000,Clint Eastwood,115095302,Clint Eastwood,1,Nick Schenk,148095302
Columbia Pictures,35000000,Robert Luketic,46159365,Jim Sturgess,3,Peter Steinfeld,81159365
Miramax,12500000,Mark Herman,-3469419,Asa Butterfield,11,John Boyne,9030581
Metro-Goldwyn-Mayer (MGM),200000000,Marc Forster,-31631573,Daniel Craig,11,Paul Haggis,168368427
Universal Pictures,30000000,Nicholas Stoller,33172463,Kristen Bell,4,Jason Segel,63172463
Voltage Pictures,15000000,Kathryn Bigelow,2017811,Jeremy Renner,7,Mark Boal,17017811
Paramount Pictures,25000000,Matt Reeves,55048433,Mike Vogel,1,Drew Goddard,80048433
Columbia Pictures,27000000,David Gordon Green,60341380,Seth Rogen,8,Seth Rogen,87341380
Fox 2000 Pictures,30000000,Anne Fletcher,46808654,Katherine Heigl,1,Aline Brosh McKenna,76808654
Paramount Pictures,185000000,Steven Spielberg,132101119,Harrison Ford,5,David Koepp,317101119
The Weinstein Company,15500000,Woody Allen,7716709,Rebecca Hall,8,Woody Allen,23216709
DreamWorks,35000000,Sam Mendes,-12088520,Leonardo DiCaprio,1,Justin Haythe,22911480
Lionsgate,35000000,Lexi Alexander,-27051841,Ray Stevenson,12,Nick Santora,7948159
Universal Pictures,145000000,Rob Cohen,-42508224,Brendan Fraser,8,Alfred Gough,102491776
Columbia Pictures,150000000,Peter Berg,77946274,Will Smith,7,Vincent Ngo,227946274
Warner Bros.,70000000,Ridley Scott,-30605334,Leonardo DiCaprio,10,William Monahan,39394666
DreamWorks Animation,130000000,Mark Osborne,85434591,Jack Black,6,Jonathan Aibel,215434591
Paramount Pictures,90000000,Mark Waters,-18804947,Freddie Highmore,2,Karey Kirkpatrick,71195053
Blue Askew,24000000,Kevin Smith,7457946,Seth Rogen,10,Kevin Smith,31457946
Twentieth Century Fox Film Corporation,48000000,M. Night Shyamalan,16506874,Mark Wahlberg,6,M. Night Shyamalan,64506874
Metro-Goldwyn-Mayer (MGM),75000000,Bryan Singer,8077833,Tom Cruise,12,Christopher McQuarrie,83077833
The Weinstein Company,32000000,Stephen Daldry,2194407,Kate Winslet,1,David Hare,34194407
Walt Disney Pictures,225000000,Andrew Adamson,-83378510,Ben Barnes,5,Andrew Adamson,141621490
Lionsgate,50000000,Sylvester Stallone,-7245895,Sylvester Stallone,1,Art Monterastelli,42754105
Warner Bros.,70000000,Andy Tennant,231041,Matthew McConaughey,2,John Claflin,70231041
Warner Bros.,80000000,Peter Segal,50319208,Steve Carell,6,Tom J. Astle,130319208
Columbia Pictures,55000000,Gabriele Muccino,14951824,Will Smith,12,Grant Nieporte,69951824
Universal Pictures,28000000,David Wain,39294270,Paul Rudd,11,Timothy Dowling,67294270
Twentieth Century Fox Film Corporation,85000000,Doug Liman,-4827872,Hayden Christensen,2,David S. Goyer,80172128
EFTI,4000000,Tomas Alfredson,-1877935,Kåre Hedebrant,12,John Ajvide Lindqvist,2122065
Summit Entertainment,20000000,Jeff Wadlow,4850922,Sean Faris,3,Chris Hauty,24850922
Columbia Pictures,35000000,Justin Chadwick,-8185043,Natalie Portman,2,Peter Morgan,26814957
Rogue Pictures,30000000,Neil Marshall,-19044575,Rhona Mitra,3,Neil Marshall,10955425
Focus Features,37000000,Ethan Coen,23355347,Brad Pitt,9,Joel Coen,60355347
The Weinstein Company,50000000,Howard McCain,-49839359,Jim Caviezel,4,Dirk Blackman,160641
Columbia Pictures,90000000,Dennis Dugan,10018837,Adam Sandler,6,Adam Sandler,100018837
Imagine Entertainment,55000000,Clint Eastwood,-19260198,Angelina Jolie,10,J. Michael Straczynski,35739802
Mosaic Media Group,20000000,Roger Donaldson,10028592,Jason Statham,3,Dick Clement,30028592
Abandon Entertainment,35000000,John Moore,5689393,Mark Wahlberg,10,Beau Thorne,40689393
New Line Cinema,45000000,Eric Brevig,56704370,Brendan Fraser,7,Michael D. Weiss,101704370
Summit Entertainment,19000000,Sean Anders,-10597515,Josh Zuckerman,10,Sean Anders,8402485
Columbia Pictures,40000000,Paul Weiland,6012734,Patrick Dempsey,5,Adam Sztykiel,46012734
Universal Pictures,45000000,Paul W.S. Anderson,-8683968,Jason Statham,8,Paul W.S. Anderson,36316032
Warner Bros.,70000000,Peyton Reed,27690976,Jim Carrey,12,Nicholas Stoller,97690976
Universal Pictures,20000000,Nick Moore,-19980220,Emma Roberts,11,Lucy Dahl,19780
Walt Disney Animation Studios,150000000,Byron Howard,-35946421,John Travolta,11,Dan Fogelman,114053579
Twisted Pictures,10800000,David Hackl,45946769,Scott Patterson,10,Patrick Melton,56746769
Fox Atomic,15000000,Peter Cattaneo,-8590472,Rainn Wilson,8,Maya Forbes,6409528
Focus Features,20000000,Gus Van Sant,11841299,Sean Penn,1,Dustin Lance Black,31841299
Babylon,70000000,Mathieu Kassovitz,-47468302,Vin Diesel,8,Maurice G. Dantec,22531698
Twentieth Century Fox Film Corporation,35000000,Tom Vaughan,45277646,Cameron Diaz,5,Dana Fox,80277646
Studio Ghibli,34000000,Hayao Miyazaki,-18909600,Cate Blanchett,8,Hayao Miyazaki,15090400
Lionsgate,25100000,Oliver Stone,434493,Josh Brolin,10,Stanley Weiser,25534493
Warner Bros.,105000000,Roland Emmerich,-10215799,Camilla Belle,3,Roland Emmerich,94784201
Fox 2000 Pictures,60000000,David Frankel,83153751,Owen Wilson,12,Scott Frank,143153751
Twentieth Century Fox Film Corporation,130000000,Baz Luhrmann,-80445998,Nicole Kidman,11,Stuart Beattie,49554002
Warner Bros.,120000000,Lana Wachowski,-76054234,Emile Hirsch,5,Lilly Wachowski,43945766
Lionsgate,60000000,Frank Miller,-40218121,Gabriel Macht,12,Frank Miller,19781879
Paramount Vantage,32000000,Edward Zwick,-3355187,Daniel Craig,1,Clayton Frohman,28644813
Picturehouse,16500000,Diane English,10402075,Meg Ryan,9,Diane English,26902075
DreamWorks,80000000,D.J. Caruso,21111837,Shia LaBeouf,9,John Glenn,101111837
New Line Cinema,12000000,Jon Hurwitz,26087366,John Cho,4,Jon Hurwitz,38087366
Sidney Kimmel Entertainment,21000000,Charlie Kaufman,-17918075,Philip Seymour Hoffman,11,Charlie Kaufman,3081925
Goodspeed Productions,20000000,John Patrick Shanley,13422556,Meryl Streep,12,John Patrick Shanley,33422556
Regency Enterprises,35000000,Alexandre Aja,-4308561,Kiefer Sutherland,8,Alexandre Aja,30691439
Twentieth Century Fox Film Corporation,80000000,Scott Derrickson,-633022,Keanu Reeves,12,David Scarpa,79366978
Blue Sky Studios,85000000,Jimmy Hayward,69529439,Jim Carrey,3,Ken Daurio,154529439
Touchstone Pictures,17500000,Jon M. Chu,40517783,Robert Hoffman,2,Toni Ann Johnson,58017783
Lionsgate,20000000,Jason Friedberg,-5809099,Carmen Electra,8,Jason Friedberg,14190901
Walt Disney Pictures,11000000,Kenny Ortega,79559416,Zac Efron,10,Peter Barsocchini,90559416
Walden Media,37000000,Jennifer Flackett,11006503,Jodie Foster,4,Joseph Kwong,48006503
New Line Cinema,60000000,Iain Softley,-42696576,Brendan Fraser,1,David Lindsay-Abaire,17303424
DreamWorks Animation,150000000,Eric Darnell,30010950,Ben Stiller,11,Etan Cohen,180010950
Casey Silver Productions,55000000,Rob Minkoff,-2924730,Jackie Chan,4,John Fusco,52075270
DreamWorks,8000000,Carter Smith,9432844,Shawn Ashmore,4,Scott B. Smith,17432844
EuropaCorp,30000000,Olivier Megaton,1715062,Jason Statham,11,Luc Besson,31715062
Fox Searchlight Pictures,20000000,David Ayer,6415649,Keanu Reeves,4,James Ellroy,26415649
New Line Cinema,55000000,Kent Alterman,-21527150,Will Ferrell,2,Scot Armstrong,33472850
New Regency Pictures,30000000,Jason Friedberg,8233676,Sean Maguire,1,Jason Friedberg,38233676
Columbia Pictures,40000000,Pete Travis,32266306,Dennis Quaid,2,Barry L. Levy,72266306
Stage 6 Films,2900000,Ric Roman Waugh,-2863244,Stephen Dorff,7,Ric Roman Waugh,36756
Screen Gems,9000000,Peter Sollett,22487293,Michael Cera,10,Lorene Scafaria,31487293
Playtone,55000000,Gil Kenan,-47126993,Saoirse Ronan,10,Caroline Thompson,7873007
Walt Disney Pictures,80000000,Adam Shankman,30101975,Adam Sandler,12,Matt Lopez,110101975
Screen Gems,12000000,John Erick Dowdle,19691811,Jennifer Carpenter,10,John Erick Dowdle,31691811
New Line Cinema,30000000,Gavin O'Connor,-14290615,Edward Norton,10,Joe Carnahan,15709385
New Line Cinema,20000000,Michel Gondry,-8830469,Jack Black,2,Michel Gondry,11169531
TriStar Pictures,25000000,Rodrigo García,-24729341,Anne Hathaway,10,Ronnie Christensen,270659
Fox Searchlight Pictures,11000000,Gina Prince-Bythewood,26766350,Dakota Fanning,10,Gina Prince-Bythewood,37766350
New Line Cinema,20000000,Ed Harris,207003,Ed Harris,10,Robert Knott,20207003
Davis Entertainment,40000000,Gary Fleder,-30410125,Rob Brown,10,Charles Leavitt,9589875
Overture Films,8000000,Christine Jeffs,4062558,Amy Adams,4,Megan Holley,12062558
Screen Gems,22000000,Neil LaBute,17263506,Samuel L. Jackson,9,David Loughery,39263506
Universal Pictures,25000000,Ron Howard,-6406844,Frank Langella,1,Peter Morgan,18593156
Yari Film Group (YFG),11500000,Rod Lurie,-11496955,Kate Beckinsale,7,Rod Lurie,3045
Alliance,20000000,Nelson McCormick,23869350,Brittany Snow,4,J.S. Cardone,43869350
Vivendi Entertainment,14700000,Fatih Akin,-13114141,Shia LaBeouf,10,Hu Hong,1585859
Regency Enterprises,8000000,Masayuki Ochiai,17926543,Joshua Jackson,3,Luke Dawson,25926543
Rifkin-Eberts,25000000,Marcel Langenegger,-20402240,Hugh Jackman,4,Mark Bomback,4597760
Lakeshore Entertainment,15000000,Ryûhei Kitamura,-14916639,Vinnie Jones,8,Jeff Buhler,83361
Millennium Films,60000000,Jon Avnet,-19918590,Robert De Niro,9,Russell Gewirtz,40081410
Dimension Films,35000000,Craig Mazin,-9128166,Drake Bell,3,Craig Mazin,25871834
Twentieth Century Fox Film Corporation,30000000,Chris Carter,-9018367,David Duchovny,7,Frank Spotnitz,20981633
Berk/Lane Entertainment,6000000,S.R. Bindler,-5963503,Matthew McConaughey,9,S.R. Bindler,36497
Lionsgate,40000000,Howard Deutch,-20780750,Kate Hudson,9,Jordan Cahan,19219250
Number 9 Films,27000000,Robert B. Weide,-24221248,Simon Pegg,10,Peter Straughan,2778752
Metro-Goldwyn-Mayer (MGM),8000000,Marc Schölermann,-7891338,Alyssa Milano,4,Mark Neveldine,108662
Endgame Entertainment,20000000,Rian Johnson,-16480373,Rachel Weisz,6,Rian Johnson,3519627
Warner Bros.,30000000,George C. Wolfe,11850659,Diane Lane,9,Ann Peacock,41850659
Screen Gems,35000000,Gregory Hoblit,-6312165,Diane Lane,1,Robert Fyvolent,28687835
2929 Productions,12000000,James Gray,-8851518,Joaquin Phoenix,3,James Gray,3148482
2929 Productions,20000000,Guillermo Arriaga,-19799601,Charlize Theron,7,Guillermo Arriaga,200399
Purple Pictures,9000000,Tom Putnam,-8972304,Paris Hilton,2,Heidi Ferrer,27696
Paramount Pictures,40000000,Steven Brill,-7146360,Owen Wilson,3,Kristofor Brown,32853640
Rhombus Media,25000000,Fernando Meirelles,-21926608,Julianne Moore,10,José Saramago,3073392
Samuel Goldwyn Films,500000,Alex Kendrick,32956317,Kirk Cameron,9,Alex Kendrick,33456317
Twisted Pictures,8500000,Darren Lynn Bousman,-8359756,Paul Sorvino,11,Darren Smith,140244
LightWave Entertainment,12000000,Darnell Martin,-3804449,Adrien Brody,12,Darnell Martin,8195551
Ponty Up Pictures,1500000,Bruce McDonald,-1496522,Stephen McHattie,9,Tony Burgess,3478
New Line Cinema,80000000,Seth Gordon,40146040,Reese Witherspoon,11,Matt Allen,120146040
DreamWorks,20000000,David Koepp,-6785970,Ricky Gervais,9,David Koepp,13214030
Broadway Video,30000000,Michael McCullers,30269340,Tina Fey,4,Michael McCullers,60269340
Garbus Kroupa Entertainment,1200000,James Bolton,-1193681,Stephan Bender,12,James Bolton,6319
Universal Pictures,58000000,George Clooney,-26800785,George Clooney,4,Duncan Brantley,31199215
Gold Circle Films,10000000,Jeff Lowell,-2436330,Eva Longoria,2,Jeff Lowell,7563670
Wild Bunch,35000000,Steven Soderbergh,-33268335,Julia Ormond,1,Peter Buchman,1731665
Initial Entertainment Group (IEG),40000000,Danny Pang,-24720320,Nicolas Cage,9,Jason Richman,15279680
Lionsgate,12000000,David Moreau,19418697,Jessica Alba,2,Sebastian Gutierrez,31418697
Paramount Pictures,62000000,Marco Schnabel,-29764207,Mike Myers,6,Mike Myers,32235793
Fox Searchlight Pictures,3000000,Clark Gregg,-73435,Sam Rockwell,9,Clark Gregg,2926565
Lucasfilm Animation,8500000,Dave Filoni,26661554,Matt Lanter,8,Henry Gilroy,35161554
Filmax International,15000000,Brad Anderson,-12796359,Woody Harrelson,9,Brad Anderson,2203641
Paramount Pictures,25000000,Kimberly Peirce,-14088250,Ryan Phillippe,3,Mark Richard,10911750
Jackson Income Fund,5000000,Michael Keaton,-4653714,Michael Keaton,12,Ron Lazzeretti,346286
Ecosse Films,20000000,Julian Jarrold,-13585437,Matthew Goode,8,Andrew Davies,6414563
Twentieth Century Fox Film Corporation,60000000,Brian Robbins,-48197944,Eddie Murphy,7,Rob Greenberg,11802056
Shocking Bottle,5000000,Randall Miller,-959412,Chris Pine,9,Jody Savin,4040588
Canal+ España,10000000,Álex de la Iglesia,-9996393,Elijah Wood,7,Álex de la Iglesia,3607
Overture Films,22000000,Jeffrey Nachmanoff,1530831,Don Cheadle,8,Jeffrey Nachmanoff,23530831
Touchstone Pictures,21000000,Joshua Michael Stern,-4715640,Kevin Costner,8,Jason Richman,16284360
Barunson,10000000,Jee-woon Kim,-9871514,Kang-ho Song,7,Jee-woon Kim,128486
2929 Productions,25000000,Barry Levinson,-23909053,Robert De Niro,10,Art Linson,1090947
Alcon Entertainment,27000000,Eric Valette,-123471,Edward Burns,1,Andrew Klavan,26876529
Senator Entertainment Co,18000000,Gregor Jordan,-17700000,Billy Bob Thornton,4,Bret Easton Ellis,300000
Bridgit Folman Film Gang,1500000,Ari Folman,783276,Ari Folman,7,Ari Folman,2283276
Exodus Film Group,25000000,Tony Leondis,-5471398,John Cusack,9,Chris McKenna,19528602
Pelican Productions LLC (I),20000000,Fred Wolf,-13436643,Steve Zahn,2,Peter Gaulke,6563357
Universal Pictures,60000000,Sam Fell,-9122855,Matthew Broderick,12,Kate DiCamillo,50877145
Edward R. Pressman Film,25000000,Simon Hunter,-24993180,Thomas Jane,1,Philip Eisner,6820
CinemaNX,25000000,Richard Linklater,-23813043,Zac Efron,12,Robert Kaplow,1186957
Occupant Entertainment,6000000,Jonathan Levine,-3922884,Josh Peck,8,Jonathan Levine,2077116
Mandeville Films,20000000,Raja Gosnell,74514402,Drew Barrymore,10,Analisa LaBianco,94514402
Lago Film,3500000,Jennifer Lynch,-3472651,Julia Ormond,4,Kent Harper,27349
Huntington Prep,5000000,Mickey Liddell,8350177,Haley Bennett,10,John Travis,13350177
Big City Pictures,22000000,Callie Khouri,-1331157,Diane Keaton,1,Glenn Gers,20668843
Universal Pictures,35000000,Malcolm D. Lee,7436517,Martin Lawrence,2,Malcolm D. Lee,42436517
Kulture Machine,8000000,Dennis Lee,-4606839,Ryan Reynolds,11,Robert Frost,3393161
40 Acres & A Mule Filmworks,45000000,Spike Lee,-37083113,Derek Luke,9,James McBride,7916887
Sony Pictures Classics,7000000,David Mamet,-4655153,Chiwetel Ejiofor,5,David Mamet,2344847
Picturehouse,10000000,Patricia Rozema,7655201,Abigail Breslin,7,Ann Peacock,17655201
Lakeshore Entertainment,13000000,Isabel Coixet,-9418358,Ben Kingsley,8,Nicholas Meyer,3581642
Element Films,6500000,Deb Hagan,-1806081,Drake Bell,8,Dan Callahan,4693919
Bona Fide Productions,9000000,Andrew Fleming,-4118133,Steve Coogan,8,Pam Brady,4881867
New Crime Productions,10000000,Joshua Seftel,-9419138,John Cusack,6,Mark Leyner,580862
Warner Bros.,130000000,Zack Snyder,-22490201,Jackie Earle Haley,3,David Hayter,107509799
Twentieth Century Fox Film Corporation,237000000,James Cameron,523507625,Sam Worthington,12,James Cameron,760507625
Universal Pictures,75000000,Quentin Tarantino,45540719,Brad Pitt,8,Quentin Tarantino,120540719
Paramount Pictures,150000000,J.J. Abrams,107730019,Chris Pine,5,Roberto Orci,257730019
Warner Bros.,35000000,Todd Phillips,242322503,Zach Galifianakis,6,Jon Lucas,277322503
Warner Bros.,250000000,David Yates,51959197,Daniel Radcliffe,7,Steve Kloves,301959197
Twentieth Century Fox Film Corporation,40000000,Wes Anderson,-18997081,George Clooney,11,Roald Dahl,21002919
Columbia Pictures,23600000,Ruben Fleischer,51990286,Jesse Eisenberg,10,Rhett Reese,75590286
Paramount Pictures,25000000,Jason Reitman,58823381,George Clooney,12,Walter Kirn,83823381
Alcon Entertainment,29000000,John Lee Hancock,226959475,Quinton Aaron,11,John Lee Hancock,255959475
New Line Cinema,19000000,Marcus Nispel,46002019,Jared Padalecki,2,Damian Shannon,65002019
Warner Bros.,90000000,Guy Ritchie,119028679,Robert Downey Jr.,12,Michael Robert Johnson,209028679
Columbia Pictures,200000000,Roland Emmerich,-33887833,John Cusack,11,Roland Emmerich,166112167
Focus Features,60000000,Henry Selick,15286229,Dakota Fanning,2,Henry Selick,75286229
Twentieth Century Fox Film Corporation,150000000,Gavin Hood,29883157,Hugh Jackman,5,David Benioff,179883157
Pixar Animation Studios,175000000,Pete Docter,118004164,Edward Asner,5,Pete Docter,293004164
Pan Européenne,47000000,Jaco Van Dormael,-46996400,Jared Leto,9,Jaco Van Dormael,3600
StudioCanal,11000000,Atom Egoyan,-7925162,Julianne Moore,3,Erin Cressida Wilson,3074838
Fox Searchlight Pictures,7500000,Marc Webb,24891374,Zooey Deschanel,8,Scott Neustadter,32391374
Halcyon Company The,200000000,McG,-74677531,Christian Bale,5,John Brancato,125322469
Liberty Films UK,5000000,Duncan Jones,9677,Sam Rockwell,7,Duncan Jones,5009677
DreamWorks,200000000,Michael Bay,202111870,Shia LaBeouf,6,Ehren Kruger,402111870
Tornasol Films,2000000,Juan José Campanella,18167424,Ricardo Darín,5,Eduardo Sacheri,20167424
Yellow Bird,13000000,Niels Arden Oplev,-2904830,Michael Nyqvist,4,Nikolaj Arcel,10095170
Twentieth Century Fox Film Corporation,30000000,James Wong,-20646427,Justin Chatwin,4,Ben Ramsey,9353573
TriStar Pictures,30000000,Neill Blomkamp,85646235,Sharlto Copley,8,Neill Blomkamp,115646235
Columbia Pictures,150000000,Ron Howard,-16624154,Tom Hanks,5,David Koepp,133375846
Fox Atomic,16000000,Karyn Kusama,204793,Megan Fox,9,Diablo Cody,16204793
Zentropa Entertainments,11000000,Lars von Trier,-10602930,Willem Dafoe,3,Lars von Trier,397070
Touchstone Pictures,40000000,Anne Fletcher,123958031,Sandra Bullock,6,Peter Chiarelli,163958031
Dimension Films,25000000,John Hillcoat,-24943308,Viggo Mortensen,12,Cormac McCarthy,56692
Film Department The,50000000,F. Gary Gray,23343413,Gerard Butler,10,Kurt Wimmer,73343413
Walt Disney Pictures,65000000,Andy Fickman,2172594,Dwayne Johnson,3,Matt Lopez,67172594
Curmudgeon Films,30000000,Nick Cassavetes,19200230,Cameron Diaz,6,Jeremy Leven,49200230
Paramount Pictures,175000000,Stephen Sommers,-22732481,Dennis Quaid,8,Stuart Beattie,152267519
Rogue Pictures,15000000,Dennis Iliadis,17721635,Garret Dillahunt,3,Adam Alleca,32721635
Universal Pictures,85000000,Justin Lin,70064265,Vin Diesel,4,Chris Morgan,155064265
DreamWorks,65000000,Peter Jackson,-21181161,Rachel Weisz,1,Fran Walsh,43818839
New Line Cinema,40000000,Ken Kwapis,53953653,Jennifer Aniston,2,Abby Kohn,93953653
Constantin Film,33000000,Christian Alvart,-22669147,Dennis Quaid,9,Travis Milloy,10330853
Universal Pictures,100000000,Michael Mann,-2895380,Christian Bale,7,Ronan Bennett,97104620
New Line Cinema,20000000,Burr Steers,44167069,Zac Efron,4,Jason Filardi,64167069
Fade to Black Productions,7000000,Tom Ford,2166863,Colin Firth,2,Christopher Isherwood,9166863
Touchstone Pictures,80000000,Jonathan Mostow,-41422228,Bruce Willis,9,Michael Ferris,38577772
Temple Hill Entertainment,50000000,Chris Weitz,246623634,Kristen Stewart,11,Melissa Rosenberg,296623634
Lionsgate,15000000,Patrick Lussier,36545952,Jensen Ackles,1,Todd Farmer,51545952
Walt Disney Animation Studios,105000000,Ron Clements,-599101,Anika Noni Rose,12,Ron Clements,104400899
Infinity Features Entertainment,40000000,Terry Gilliam,-32310393,Christopher Plummer,1,Terry Gilliam,7689607
DreamWorks,40000000,John Hamburg,31440011,Paul Rudd,3,John Hamburg,71440011
Universal Pictures,40000000,Paul Weitz,-26161870,Chris Massoglia,10,Paul Weitz,13838130
GK Films,35000000,Jean-Marc Vallée,-23998728,Emily Blunt,1,Julian Fellowes,11001272
Lionsgate,26000000,Jim Sheridan,2501651,Jake Gyllenhaal,12,David Benioff,28501651
MPI Media Group,900000,Ti West,-799341,Jocelin Donahue,5,Ti West,100659
Dimension Films,15000000,Rob Zombie,18392973,Scout Taylor-Compton,8,Rob Zombie,33392973
Columbia Pictures,38000000,Robert Luketic,50915214,Katherine Heigl,7,Nicole Eastman,88915214
Columbia Pictures,60000000,Harold Ramis,-16662721,Jack Black,6,Harold Ramis,43337279
Screen Gems,20000000,Will Gluck,-2768709,Eric Christian Olsen,2,Will Gluck,17231291
Columbia Pictures,40000000,Nora Ephron,54125426,Amy Adams,8,Nora Ephron,94125426
Focus Features,30000000,Shane Acker,1743332,Elijah Wood,9,Pamela Pettler,31743332
New Line Cinema,40000000,David R. Ellis,26477700,Nick Zano,8,Eric Bress,66477700
Fox Searchlight Pictures,20000000,George Tillman Jr.,16842118,Jamal Woolard,1,Reggie Rock Bythewood,36842118
The Weinstein Company,80000000,Rob Marshall,-60335979,Daniel Day-Lewis,12,Michael Tolkin,19664021
CJ Entertainment,5000000,Joon-ho Bong,-4452708,Hye-ja Kim,5,Joon-ho Bong,547292
Pathé Renn Productions,8500000,Jane Campion,-4055363,Abbie Cornish,10,Jane Campion,4444637
Summit Entertainment,38000000,Paul McGuigan,-6193900,Camilla Belle,2,David Bourla,31806100
Universal Pictures,75000000,Judd Apatow,-23144955,Adam Sandler,7,Judd Apatow,51855045
Lionsgate,10000000,Lee Daniels,37395661,Gabourey Sidibe,11,Geoffrey Fletcher,47395661
Twisted Pictures,11000000,Kevin Greutert,16669413,Tobin Bell,10,Patrick Melton,27669413
Lionsgate,50000000,Mark Neveldine,-29511421,Gerard Butler,9,Mark Neveldine,20488579
Fox 2000 Pictures,30000000,Gary Winick,28715510,Kate Hudson,1,Greg DePaul,58715510
Universal Pictures,60000000,Peter Billingsley,49205660,Vince Vaughn,10,Jon Favreau,109205660
Universal Pictures,30000000,Sam Raimi,12100625,Alison Lohman,5,Sam Raimi,42100625
Universal Pictures,50000000,Richard Curtis,-42005885,Philip Seymour Hoffman,11,Richard Curtis,7994115
Gaumont,26000000,Vincenzo Natali,-9000954,Adrien Brody,6,Vincenzo Natali,16999046
Sketch Films,35000000,Patrick Tatopoulos,10802315,Rhona Mitra,1,Danny McBride,45802315
Lionsgate,20000000,Michael Spierig,10101577,Ethan Hawke,1,Michael Spierig,30101577
DreamWorks Animation,175000000,Rob Letterman,23351526,Reese Witherspoon,3,Maya Forbes,198351526
Columbia Pictures,26000000,Steve Carr,-5180871,Kevin James,1,Kevin James,20819129
Columbia Pictures,100000000,Tony Scott,-34547688,Denzel Washington,6,Brian Helgeland,65452312
New Line Cinema,39000000,Robert Schwentke,24414846,Eric Bana,8,Bruce Joel Rubin,63414846
Summit Entertainment,50000000,Alex Proyas,29957634,Nicolas Cage,3,Ryne Douglas Pearson,79957634
Focus Features,7000000,Ethan Coen,2190525,Michael Stuhlbarg,11,Joel Coen,9190525
Columbia Pictures,100000000,Phil Lord,24870275,Anna Faris,9,Phil Lord,124870275
BBC Films,25000000,Grant Heslov,7416109,Ewan McGregor,11,Jon Ronson,32416109
Fox Atomic,6000000,Zach Cregger,-1457225,Zach Cregger,3,Zach Cregger,4542775
Warner Bros.,16000000,Richard Kelly,-954324,Cameron Diaz,11,Richard Kelly,15045676
LD Entertainment,6000000,Marcus Dunstan,1706394,Josh Stewart,7,Patrick Melton,7706394
Warner Bros.,60000000,Clint Eastwood,-22508636,Morgan Freeman,12,Anthony Peckham,37491364
Twentieth Century Fox Film Corporation,150000000,Shawn Levy,27243721,Ben Stiller,5,Robert Ben Garant,177243721
Universal Pictures,100000000,Brad Silberling,-50561630,Will Ferrell,6,Chris Henchy,49438370
Paramount Vantage,26000000,Christian Alvart,-12751523,Renée Zellweger,10,Ray Wright,13248477
Universal Pictures,85000000,Nancy Meyers,27735375,Meryl Streep,12,Nancy Meyers,112735375
Warner Bros.,100000000,Spike Jonze,-22766533,Max Records,10,Spike Jonze,77233467
Lionsgate,20000000,Mark Neveldine,-6369774,Jason Statham,4,Mark Neveldine,13630226
Fox Searchlight Pictures,7000000,Scott Cooper,32462438,Jeff Bridges,2,Scott Cooper,39462438
Rogue Pictures,16000000,David S. Goyer,26670410,Odette Annable,1,David S. Goyer,42670410
DreamWorks,35000000,Thor Freudenthal,38034460,Emma Roberts,1,Jeff Lowell,73034460
It's a Laugh Productions,30000000,Peter Chelsom,49566871,Miley Cyrus,4,Dan Berendsen,79566871
Mod Producciones,70000000,Alejandro Amenábar,-69382160,Rachel Weisz,9,Alejandro Amenábar,617840
Screen Gems,20000000,Steve Shill,48261644,Beyoncé Knowles,4,David Loughery,68261644
Universal Pictures,42000000,Larry Charles,18054530,Sacha Baron Cohen,7,Sacha Baron Cohen,60054530
Universal Pictures,10000000,Olatunde Osunsanmi,15464480,Milla Jovovich,11,Olatunde Osunsanmi,25464480
Warner Bros.,40000000,James McTeigue,-1894923,Rick Yune,11,Matthew Sand,38105077
Sony Pictures Classics,15000000,Woody Allen,-9693553,Evan Rachel Wood,7,Woody Allen,5306447
Warner Bros.,35000000,Dominic Sena,-24724362,Kate Beckinsale,9,Jon Hoeber,10275638
Paramount Pictures,22000000,George Gallo,-21276286,Luke Wilson,8,George Gallo,723714
Warner Bros.,18500000,Ricky Gervais,-60918,Ricky Gervais,10,Ricky Gervais,18439082
Ternion Pictures,8000000,Mike Judge,2814185,Jason Bateman,9,Mike Judge,10814185
Twentieth Century Fox Animation,90000000,Carlos Saldanha,106573705,Ray Romano,7,Peter Ackerman,196573705
Fox 2000 Pictures,75000000,Betty Thomas,144614612,Jason Lee,12,Jon Vitti,219614612
Rogue,14000000,David Twohy,1483540,Milla Jovovich,8,David Twohy,15483540
Mandate Pictures,15000000,Drew Barrymore,-1956637,Ellen Page,10,Shauna Cross,13043363
Walt Disney Pictures,200000000,Robert Zemeckis,-62144137,Jim Carrey,11,Robert Zemeckis,137855863
Columbia Pictures,50000000,Tom Tykwer,-24549473,Clive Owen,2,Eric Warren Singer,25450527
Walt Disney Pictures,35000000,Walt Becker,14492060,Robin Williams,11,David Diamond,49492060
Stage 6 Films,8000000,Troy Duffy,2269307,Sean Patrick Flanery,12,Troy Duffy,10269307
Millennium Films,17000000,Antoine Fuqua,10154426,Richard Gere,3,Michael C. Martin,27154426
Destination Films,2900000,Scott Sanders,-2671523,Arsenio Hall,1,Michael Jai White,228477
Warner Bros.,22000000,Steven Soderbergh,11313582,Matt Damon,9,Scott Z. Burns,33313582
De Line Pictures,18000000,Jody Hill,5993605,Seth Rogen,4,Jody Hill,23993605
EuropaCorp,13000000,Glenn Ficarra,-10964434,Jim Carrey,1,John Requa,2035566
Fox 2000 Pictures,15000000,Phil Traill,18860010,Sandra Bullock,9,Kim Barker,33860010
Magnolia Pictures,1700000,Steven Soderbergh,-1004583,Sasha Grey,7,David Levien,695417
Metro-Goldwyn-Mayer (MGM),18000000,Kevin Tancharoen,4455510,Kelsey Grammer,9,Allison Burnett,22455510
Fox Atomic,18000000,Chris Columbus,-3206096,Hayden Panettiere,7,Larry Doyle,14793904
Dimension Films,18000000,Miguel Arteta,-2718714,Michael Cera,1,Gustin Nash,15281286
Universal Pictures,60000000,Tony Gilroy,-19427175,Julia Roberts,3,Tony Gilroy,40572825
Focus Features,17000000,Sam Mendes,-7548054,John Krasinski,6,Dave Eggers,9451946
The Weinstein Company,3900000,Kyle Newman,-3211471,Dan Fogler,2,Ernest Cline,688529
Marv Films,7300000,Daniel Barber,-5481319,Michael Caine,5,Gary Young,1818681
Lionsgate,8000000,Jonas Elmer,8734283,Renée Zellweger,1,Ken Rance,16734283
Millennium Films,20000000,Werner Herzog,-18302044,Nicolas Cage,12,William M. Finkelstein,1697956
CJ Entertainment,5000000,Chan-wook Park,-4703559,Kang-ho Song,7,Seo-kyeong Jeong,296441
House Row Productions,16000000,Stewart Hendler,-4043793,Briana Evigan,9,Josh Stolberg,11956207
DreamWorks,60000000,Joe Wright,-28329069,Jamie Foxx,4,Susannah Grant,31670931
Lleju Productions,4500000,Agnieszka Wojtowicz-Vosloo,-4391771,Christina Ricci,6,Agnieszka Wojtowicz-Vosloo,108229
Euforia Film,800000,Tommy Wirkola,-758291,Jeppe Beck Laursen,1,Tommy Wirkola,41709
Twentieth Century Fox Film Corporation,45000000,John Schultz,-19799588,Ashley Tisdale,7,Mark Burton,25200412
Hyde Park Entertainment,18000000,Andrzej Bartkowiak,-9257739,Kristin Kreuk,2,Justin Marks,8742261
Miramax,21000000,Kirk Jones,-12144354,Robert De Niro,12,Kirk Jones,8855646
Jerry Bruckheimer Films,150000000,Hoyt Yeatman,-30563230,Will Arnett,7,Cormac Wibberley,119436770
Universal Pictures,18000000,Brandon Camp,4927390,Jennifer Aniston,9,Brandon Camp,22927390
Warner Bros.,40000000,Robert Rodriguez,-19083691,Jimmy Bennett,8,Robert Rodriguez,20916309
The Weinstein Company,19000000,Wayne Kramer,-18545851,Harrison Ford,7,Wayne Kramer,454149
Echo Lake Entertainment,5000000,Derrick Borte,-3525492,Demi Moore,4,Randy T. Dinzler,1474508
Metro-Goldwyn-Mayer (MGM),70000000,Harald Zwart,-34077022,Steve Martin,2,Scott Neustadter,35922978
Imagi Animation Studios,65000000,David Bowers,-45451936,Freddie Highmore,10,Osamu Tezuka,19548064
Ilion Animation Studios,70000000,Jorge Blanco,-27913113,Dwayne Johnson,11,Javier Abad,42086887
Columbia Pictures,58000000,Marc Lawrence,-28419913,Hugh Grant,12,Marc Lawrence,29580087
Bill Kenwright Films,23000000,Stephen Frears,-20291812,Michelle Pfeiffer,7,Christopher Hampton,2708188
Fox Atomic,22000000,Renny Harlin,-9767063,John Cena,3,Daniel Kunka,12232937
Fox Searchlight Pictures,40000000,Mira Nair,-25758966,Hilary Swank,10,Ronald Bass,14241034
Universal Pictures International (UPI),18000000,Pedro Almodóvar,-12985695,Penélope Cruz,1,Pedro Almodóvar,5014305
Focus Features,30000000,Ang Lee,-22556993,Demetri Martin,8,James Schamus,7443007
Filmax,5600000,Jaume Balagueró,-5572234,Jonathan D. Mellor,10,Jaume Balagueró,27766
Columbia Pictures Corporation,10000000,Tom Hooper,-9550442,Colm Meaney,3,Peter Morgan,449558
Insight Film Releasing,3500000,Peter Stebbings,-3455538,Woody Harrelson,5,Peter Stebbings,44462
Screen Gems,27000000,Nimród Antal,-11011124,Columbus Short,12,James V. Simpson,15988876
Millennium Films,15000000,Brian Koppelman,-10639452,Michael Douglas,6,Brian Koppelman,4360548
26 Films,17000000,Donald Petrie,-8337682,Nia Vardalos,6,Mike Reiss,8662318
CineSon Entertainment,6000000,Raymond De Felitta,670712,Andy Garcia,4,Raymond De Felitta,6670712
CinemaNX,800000,J Blakeson,-633020,Gemma Arterton,4,J Blakeson,166980
Belladonna Productions,8000000,Julio DePietro,-7899497,Alexis Bledel,2,Julio DePietro,100503
Blank of the Dead Productions,4000000,George A. Romero,-3898260,Alan Van Sprang,5,George A. Romero,101740
Oscilloscope,6500000,Oren Moverman,-6433363,Ben Foster,12,Alessandro Camon,66637
K5 International,7500000,Aaron Schneider,1676553,Robert Duvall,8,Chris Provenzano,9176553
Wayfare Entertainment,12000000,Neil Jordan,-11451066,Colin Farrell,4,Neil Jordan,548934
American Zoetrope,5000000,Francis Ford Coppola,-4481478,Vincent Gallo,9,Mauricio Kartun,518522
Middle Fork Productions,10000000,Richard Harrah,-9998215,Eion Bailey,10,Steve Allrich,1785
Tyler Perry Company The,13000000,Tyler Perry,38733921,Tyler Perry,9,Tyler Perry,51733921
Tax Credit Finance,3000000,Francesca Gregorini,-2994995,Rooney Mara,1,Tatiana von Furstenberg,5005
Autonomous Films,25000000,Peter Hyams,-24967591,Jesse Metcalfe,9,Peter Hyams,32409
Warner Bros.,160000000,Christopher Nolan,132576195,Leonardo DiCaprio,7,Christopher Nolan,292576195
Fox Searchlight Pictures,13000000,Darren Aronofsky,93954678,Natalie Portman,12,Mark Heyman,106954678
Universal Pictures,60000000,Edgar Wright,-28505730,Michael Cera,8,Michael Bacall,31494270
Paramount Pictures,80000000,Martin Scorsese,48012934,Leonardo DiCaprio,2,Laeta Kalogridis,128012934
Marv Films,30000000,Matthew Vaughn,18071303,Aaron Taylor-Johnson,4,Jane Goldman,48071303
DreamWorks,20000000,Jim Field Smith,11584722,Jay Baruchel,3,Sean Anders,31584722
Warner Bros.,125000000,Louis Leterrier,38214888,Sam Worthington,4,Travis Beacham,163214888
micro_scope,6800000,Denis Villeneuve,57096,Lubna Azabal,7,Denis Villeneuve,6857096
Alliance Films,1500000,James Wan,52509150,Patrick Wilson,4,Leigh Whannell,54009150
Columbia Pictures,40000000,David Fincher,56962694,Jesse Eisenberg,10,Aaron Sorkin,96962694
Universal Pictures,69000000,Pierre Coffin,182513985,Steve Carell,7,Cinco Paul,251513985
Warner Bros.,37000000,Ben Affleck,55186262,Ben Affleck,9,Peter Craig,92186262
Walt Disney Animation Studios,260000000,Nathan Greno,-59178064,Mandy Moore,11,Dan Fogelman,200821936
Fox 2000 Pictures,95000000,Chris Columbus,-6238280,Logan Lerman,2,Craig Titley,88761720
See-Saw Films,15000000,Tom Hooper,123797449,Colin Firth,12,David Seidler,138797449
Screen Gems,8000000,Will Gluck,50401464,Emma Stone,9,Bert V. Royal,58401464
Paramount Pictures,200000000,Jon Favreau,112433331,Robert Downey Jr.,5,Justin Theroux,312433331
Fox 2000 Pictures,30000000,Edward Zwick,2367005,Jake Gyllenhaal,11,Charles Randolph,32367005
Walt Disney Pictures,170000000,Joseph Kosinski,2062763,Jeff Bridges,12,Edward Kitsis,172062763
Bold Films,26000000,Scott Stewart,14168080,Paul Bettany,1,Peter Schink,40168080
Walt Disney Pictures,200000000,Tim Burton,134191110,Mia Wasikowska,3,Linda Woolverton,334191110
Paramount Pictures,38000000,Ethan Coen,133243005,Jeff Bridges,12,Joel Coen,171243005
New Line Cinema,35000000,Samuel Bayer,28075011,Jackie Earle Haley,4,Wesley Strick,63075011
Summit Entertainment,58000000,Robert Schwentke,32380162,Bruce Willis,10,Jon Hoeber,90380162
Alcon Entertainment,80000000,Albert Hughes,14835059,Denzel Washington,1,Gary Whitta,94835059
New Line Cinema,100000000,Michael Patrick King,-4652308,Sarah Jessica Parker,5,Michael Patrick King,95347692
Twentieth Century Fox Film Corporation,110000000,Joe Carnahan,-32777901,Liam Neeson,6,Joe Carnahan,77222099
Twentieth Century Fox Film Corporation,117000000,James Mangold,-40576965,Tom Cruise,6,Patrick O'Neill,76423035
Walt Disney Pictures,200000000,Lee Unkrich,215004880,Tom Hanks,6,John Lasseter,415004880
Incentive Filmed Entertainment,3500000,Derek Cianfrance,6237892,Ryan Gosling,1,Derek Cianfrance,9737892
Cinetel Films,2000000,Steven R. Monroe,-1906949,Sarah Butler,3,Adam Rockoff,93051
DreamWorks Animation,165000000,Dean DeBlois,52581231,Jay Baruchel,3,William Davies,217581231
Summit Entertainment,16000000,Allen Coulter,3068240,Robert Pattinson,3,Will Fetters,19068240
Walt Disney Pictures,200000000,Mike Newell,-109240324,Jake Gyllenhaal,5,Boaz Yakin,90759676
Closest to the Hole Productions,25000000,David O. Russell,68617009,Mark Wahlberg,12,Scott Silver,93617009
DNA Films,15000000,Mark Romanek,-12565348,Keira Knightley,10,Kazuo Ishiguro,2434652
Columbia Pictures,80000000,Dennis Dugan,82001186,Adam Sandler,6,Adam Sandler,162001186
Universal Pictures,35000000,Susanna White,-5802358,Emma Thompson,8,Emma Thompson,29197642
Twisted Pictures,20000000,Kevin Greutert,25710178,Tobin Bell,10,Patrick Melton,45710178
Universal Pictures,200000000,Ridley Scott,-94730270,Russell Crowe,5,Brian Helgeland,105269730
Columbia Pictures,110000000,Phillip Noyce,8311368,Angelina Jolie,7,Kurt Wimmer,118311368
Millennium Films,80000000,Sylvester Stallone,23068524,Sylvester Stallone,8,Dave Callaham,103068524
Paramount Pictures,150000000,M. Night Shyamalan,-18435269,Noah Ringer,7,M. Night Shyamalan,131564731
Josephson Entertainment,38000000,Greg Berlanti,15374681,Katherine Heigl,10,Ian Deitchman,53374681
Twentieth Century Fox Film Corporation,55000000,Shawn Levy,43711404,Steve Carell,4,Josh Klausner,98711404
Screen Gems,55000000,Steve Antin,-15559345,Cher,11,Steve Antin,39440655
Pathé,18000000,Danny Boyle,335230,James Franco,1,Danny Boyle,18335230
Twentieth Century Fox Film Corporation,40000000,Nimród Antal,12000688,Adrien Brody,7,Alex Litvak,52000688
Lionsgate,35000000,Paul Haggis,-13851349,Russell Crowe,11,Paul Haggis,21148651
Columbia Pictures,100000000,Adam McKay,19219978,Will Ferrell,8,Adam McKay,119219978
Universal Pictures,19000000,Anand Tucker,6918920,Amy Adams,1,Deborah Kaplan,25918920
Columbia Pictures,40000000,Harald Zwart,136591618,Jackie Chan,6,Christopher Murphey,176591618
Summit Entertainment,68000000,David Slade,232531751,Kristen Stewart,6,Melissa Rosenberg,300531751
Touchstone Pictures,55000000,Mark Steven Johnson,-22330445,Kristen Bell,1,David Diamond,32669555
Anonymous Content,2000000,Debra Granik,4531503,Jennifer Lawrence,7,Debra Granik,6531503
Dimension Films,24000000,Alexandre Aja,1003155,Elisabeth Shue,8,Pete Goldfinger,25003155
Metro-Goldwyn-Mayer (MGM),36000000,Steve Pink,14287556,John Cusack,3,Josh Heald,50287556
Twentieth Century Fox Film Corporation,100000000,Tony Scott,-18437058,Denzel Washington,11,Mark Bomback,81562942
CBS Films,24000000,George Tillman Jr.,-759980,Dwayne Johnson,11,Tony Gayton,23240020
Pathé Pictures International,12000000,Neil Marshall,-11877712,Michael Fassbender,7,Neil Marshall,122288
Fox 2000 Pictures,15000000,Elizabeth Allen Rosenbaum,11161406,Joey King,7,Laurie Craig,26161406
Color Force,15000000,Thor Freudenthal,49003625,Zachary Gordon,3,Jackie Filgo,64003625
New Line Cinema,52000000,Garry Marshall,58485654,Julia Roberts,2,Katherine Fugate,110485654
Warner Bros.,80000000,Martin Campbell,-36686110,Mel Gibson,1,William Monahan,43313890
Universal Pictures,44000000,Burr Steers,-12837455,Zac Efron,7,Craig Pearce,31162545
Overture Films,20000000,Matt Reeves,-7865580,Kodi Smit-McPhee,10,Matt Reeves,12134420
DreamWorks Animation,130000000,Tom McGrath,18415853,Will Ferrell,11,Alan Schoolcraft,148415853
Audiovisual Aval SGR,3000000,Rodrigo Cortés,-1971342,Ryan Reynolds,10,Chris Sparling,1028658
DreamWorks Animation,165000000,Mike Mitchell,73371987,Mike Myers,5,William Steig,238371987
Castle Rock Entertainment,14000000,Rob Reiner,-12247786,Madeline Carroll,9,Rob Reiner,1752214
GK Films,100000000,Florian Henckel von Donnersmarck,-32368843,Johnny Depp,12,Florian Henckel von Donnersmarck,67631157
Touchstone Pictures,20000000,Andy Fickman,5702053,Kristen Bell,9,Moe Jelline,25702053
Fox 2000 Pictures,155000000,Michael Apted,-50613050,Ben Barnes,12,Christopher Markus,104386950
Overnight Films,10500000,Ethan Maniquis,16093646,Danny Trejo,9,Robert Rodriguez,26593646
Walt Disney Pictures,150000000,Jon Turteltaub,-86849009,Nicolas Cage,7,Lawrence Konner,63150991
Twentieth Century Fox Film Corporation,70000000,Oliver Stone,-17525384,Shia LaBeouf,9,Allan Loeb,52474616
Screen Gems,25000000,Lasse Hallström,55014842,Channing Tatum,2,Jamie Linden,80014842
Columbia Pictures,60000000,Ryan Murphy,20574010,Julia Roberts,8,Ryan Murphy,80574010
Warner Bros.,65000000,Todd Phillips,35539043,Robert Downey Jr.,11,Alan R. Cohen,100539043
Warner Bros.,25000000,Sylvain White,-1419265,Idris Elba,4,Peter Berg,23580735
Overture Films,20000000,Breck Eisner,19123589,Radha Mitchell,2,Scott Kosar,39123589
Focus Features,8000000,Anna Boden,-1649942,Keir Gilchrist,10,Anna Boden,6350058
Universal Pictures,100000000,Paul Weitz,48383780,Ben Stiller,12,John Hamburg,148383780
This Is That Productions,2500000,James Gunn,-2177843,Rainn Wilson,6,James Gunn,322157
Touchstone Pictures,20000000,Julie Anne Robinson,42950384,Miley Cyrus,3,Nicholas Sparks,62950384
Constantin Film,60000000,Paul W.S. Anderson,128566,Milla Jovovich,9,Paul W.S. Anderson,60128566
Universal Pictures,10000000,John Erick Dowdle,23583175,Chris Messina,9,Brian Nelson,33583175
Mandate Pictures,19000000,Josh Gordon,8758465,Jennifer Aniston,8,Allan Loeb,27758465
R.P. Productions,45000000,Roman Polanski,-29458451,Ewan McGregor,3,Robert Harris,15541549
Universal Pictures,150000000,Joe Johnston,-88020320,Benicio Del Toro,2,Andrew Kevin Walker,61979680
Screen Gems,20000000,John Luessenhop,37744720,Chris Brown,8,Peter Allen,57744720
Warner Bros.,47000000,Jimmy Hayward,-36460586,Josh Brolin,6,Mark Neveldine,10539414
CBS Films,35000000,Alan Poul,2490007,Jennifer Lopez,4,Kate Angelo,37490007
Columbia Pictures,40000000,Andy Tennant,27061228,Jennifer Aniston,3,Sarah Thorp,67061228
River Road Entertainment,10000000,Floria Sigismondi,-6428265,Kristen Stewart,3,Floria Sigismondi,3571735
Rogue Pictures,10000000,Colin Strause,11371425,Eric Balfour,11,Joshua Cordes,21371425
Columbia Pictures,120000000,James L. Brooks,-89787380,Reese Witherspoon,12,James L. Brooks,30212620
Focus Features,7000000,Sofia Coppola,-5231584,Stephen Dorff,1,Sofia Coppola,1768416
Miramax,20000000,John Madden,11177548,Helen Mirren,8,Matthew Vaughn,31177548
Olympus Pictures,3200000,Mike Mills,2590894,Ewan McGregor,8,Mike Mills,5790894
Lionsgate,75000000,Robert Luketic,-27940037,Katherine Heigl,6,Bob DeRosa,47059963
Summit Entertainment,30000000,Gary Winick,23032453,Amanda Seyfried,5,Jose Rivera,53032453
Olympus Pictures,5000000,John Cameron Mitchell,-2770942,Nicole Kidman,1,David Lindsay-Abaire,2229058
Millennium Films,9500000,David Schwimmer,-9379984,Clive Owen,3,Andy Bellin,120016
EuropaCorp,52000000,Pierre Morel,-28020259,John Travolta,2,Adi Hasak,23979741
Universal Pictures,100000000,Paul Greengrass,-64946340,Matt Damon,3,Brian Helgeland,35053660
Focus Features,3500000,Lisa Cholodenko,17311365,Annette Bening,7,Lisa Cholodenko,20811365
Warner Bros.,50000000,Clint Eastwood,-17253059,Matt Damon,10,Peter Morgan,32746941
Relativity Media,28000000,Brian Levant,-3731172,Jackie Chan,1,Jonathan Bernstein,24268828
Focus Features,20000000,Anton Corbijn,15606376,George Clooney,9,Rowan Joffe,35606376
Magic Light Pictures,8000000,Jonathan Lynn,-7882810,Bill Nighy,6,Lucinda Coxon,117190
Sedic International,6000000,Takashi Miike,-5197476,Kôji Yakusho,9,Kaneo Ikegami,802524
Warner Bros.,80000000,Zack Snyder,-24324687,Jim Sturgess,9,John Orloff,55675313
River Road Entertainment,22000000,Doug Liman,-12471908,Naomi Watts,12,Jez Butterworth,9528092
Warner Bros.,37000000,Kevin Smith,7875481,Bruce Willis,2,Robb Cullen,44875481
Summit Entertainment,30000000,Jon M. Chu,12400223,Sharni Vinson,8,Amy Andelson,42400223
Studio Ghibli,23000000,Hiromasa Yonebayashi,-3797257,Bridgit Mendler,2,Mary Norton,19202743
Screen Gems,20000000,Neil LaBute,22739347,Chris Rock,4,Dean Craig,42739347
Miramax,25000000,Troy Nixey,-957510,Katie Holmes,8,Guillermo del Toro,24042490
Dharma Productions,12000000,Karan Johar,-7981305,Shah Rukh Khan,2,Shibani Bathija,4018695
Universal Pictures,32000000,Miguel Sapochnik,-18205165,Jude Law,3,Eric Garcia,13794835
Regency Enterprises,20000000,Jason Friedberg,16661504,Jenn Proske,8,Jason Friedberg,36661504
Bad Robot,40000000,Roger Michell,-8988268,Rachel McAdams,11,Aline Brosh McKenna,31011732
Not specified,15000000,John Wells,-10560937,Ben Affleck,2,John Wells,4439063
Twentieth Century Fox Film Corporation,48000000,Michael Lembeck,12022256,Dwayne Johnson,1,Lowell Ganz,60022256
Glass Eye Pix,650000,Jim Mickle,-631531,Connor Paolo,12,Nick Damici,18469
Walt Disney Pictures,35000000,Randall Wallace,24713955,Diane Lane,10,Mike Rich,59713955
Realitism Films,500000,Quentin Dupieux,-401983,Stephen Spinella,11,Quentin Dupieux,98017
Mediapro,22000000,Woody Allen,-18752184,Anthony Hopkins,10,Woody Allen,3247816
Hero Entertainment,13000000,Michael Winterbottom,-12785034,Casey Affleck,12,John Curran,214966
Twentieth Century Fox Film Corporation,112000000,Rob Letterman,-69220739,Jack Black,12,Joe Stillman,42779261
Les Productions du Trésor,25000000,Guillaume Canet,-24793912,François Cluzet,10,Guillaume Canet,206088
Broadway Video,10000000,Jorma Taccone,-1539005,Will Forte,5,Will Forte,8460995
Paramount Pictures,3000000,Tod Williams,81752907,Katie Featherston,10,Michael R. Perry,84752907
Strike Entertainment,1800000,Daniel Stamm,39234350,Patrick Fabian,8,Huck Botko,41034350
Millennium Films,22000000,John Curran,-20203976,Edward Norton,10,Angus MacLachlan,1796024
New Line Cinema,32000000,Nanette Burstein,-14195701,Drew Barrymore,9,Geoff LaTulippe,17804299
Last Picture Company The,7000000,Spencer Susser,-6617054,Joseph Gordon-Levitt,6,Spencer Susser,382946
Annapurna Productions,8000000,Mitch Glazer,-7996331,Mickey Rourke,7,Mitch Glazer,3669
The Weinstein Company,4000000,Abe Sylvia,-3946370,Juno Temple,7,Abe Sylvia,53630
Omega Entertainment,12500000,Tony Goldwyn,-5716871,Hilary Swank,11,Pamela Gray,6783129
GK Films,25000000,William Monahan,-24993089,Colin Farrell,11,William Monahan,6911
American Film Company The,25000000,Robert Redford,-13461796,Robin Wright,4,James D. Solomon,11538204
Miramax,20000000,Julie Taymor,-19722057,Helen Mirren,1,Julie Taymor,277943
Scott Free Productions,7000000,Jay Duplass,455447,John C. Reilly,7,Mark Duplass,7455447
Warner Bros.,80000000,Eric Brevig,20246011,Dan Aykroyd,12,J.R. Ventimilia,100246011
Screen Gems,15000000,Shana Feste,5218921,Garrett Hedlund,1,Shana Feste,20218921
Stacey Testro International,500000,Nick Tomnay,-451570,David Hyde Pierce,5,Nick Tomnay,48430
Ealing Studios,10000000,John Landis,-9995167,Bill Bailey,9,Piers Ashworth,4833
Aramid Entertainment Fund,25000000,Taylor Hackford,-24865096,Helen Mirren,1,Mark Jacobson,134904
Audley Films,7200000,Nigel Cole,-6105202,Sally Hawkins,6,William Ivory,1094798
10th Hole Productions,4500000,Galt Niederhoffer,-4396720,Katie Holmes,5,Galt Niederhoffer,103280
Temple Hill Entertainment,5000000,Dan Rush,-2288790,Will Ferrell,10,Dan Rush,2711210
Rogue,45000000,Sngmoo Lee,-39335749,Dong-gun Jang,12,Sngmoo Lee,5664251
Rogue,25000000,Wes Craven,-10362510,Max Thieriot,10,Wes Craven,14637490
CBS Films,31000000,Tom Vaughan,-19145306,Brendan Fraser,1,Robert Nelson Jacobs,11854694
ArieScope Pictures,800000,Adam Green,-738000,Danielle Harris,11,Adam Green,62000
Twentieth Century Fox Film Corporation,50000000,Tom Dey,-16355212,Owen Wilson,6,Tim Rasmussen,33644788
Hyde Park Films,20000000,Kevin Munroe,-18816646,Brandon Routh,4,Thomas Dean Donnelly,1183354
An Olive Branch Productions,15000000,George Hickenlooper,-13960131,Kevin Spacey,1,Norman Snider,1039869
Company Films,12000000,Malcolm Venville,-11898118,Keanu Reeves,1,Sacha Gervasi,101882
CD2 Films,85000000,Brad Peyton,-41414247,Bette Midler,7,Ron J. Friedman,43585753
Summit Entertainment,35000000,Roger Kumble,-17403744,Brendan Fraser,4,Michael Carnes,17596256
Herrick Entertainment,10000000,Brad Anderson,-9977803,Hayden Christensen,2,Anthony Jaswinski,22197
Tiny Ponies,65000,Lena Dunham,324804,Lena Dunham,3,Lena Dunham,389804
Lions Gate Family Entertainment,20000000,Anthony Bell,5077977,Hayden Panettiere,9,Chris Denk,25077977
Warner Bros.,125000000,David Yates,256011219,Daniel Radcliffe,7,Steve Kloves,381011219
Universal Pictures,163000000,Jon Favreau,-62759449,Daniel Craig,7,Roberto Orci,100240551
Walt Disney Pictures,250000000,Rob Marshall,-8928198,Johnny Depp,5,Ted Elliott,241071802
FilmDistrict,15000000,Nicolas Winding Refn,20060689,Ryan Gosling,9,Hossein Amini,35060689
DreamWorks,25000000,Tate Taylor,144708112,Emma Stone,8,Tate Taylor,169708112
Carousel Productions (II),50000000,Glenn Ficarra,34351197,Steve Carell,7,Dan Fogelman,84351197
Columbia Pictures,90000000,David Fincher,12515793,Daniel Craig,12,Steven Zaillian,102515793
Universal Pictures,32500000,Paul Feig,136606725,Kristen Wiig,5,Kristen Wiig,169106725
Warner Bros.,82000000,Zack Snyder,-45607498,Emily Browning,3,Zack Snyder,36392502
Paramount Pictures,150000000,Kenneth Branagh,31030624,Chris Hemsworth,5,Ashley Miller,181030624
Paramount Pictures,140000000,Joe Johnston,36654505,Chris Evans,7,Christopher Markus,176654505
Lionsgate,25000000,Gavin O'Connor,-11342885,Tom Hardy,9,Gavin O'Connor,13657115
Twentieth Century Fox Film Corporation,160000000,Matthew Vaughn,-13591695,James McAvoy,6,Ashley Miller,146408305
Warner Bros.,200000000,Martin Campbell,-83398828,Ryan Reynolds,6,Greg Berlanti,116601172
Relativity Media,27000000,Neil Burger,52249455,Bradley Cooper,3,Leslie Dixon,79249455
Relativity Media,75000000,Tarsem Singh,8504017,Henry Cavill,11,Charley Parlapanides,83504017
Paramount Pictures,50000000,J.J. Abrams,77004179,Elle Fanning,6,J.J. Abrams,127004179
Twentieth Century Fox Film Corporation,93000000,Rupert Wyatt,83760185,James Franco,8,Rick Jaffa,176760185
Screen Gems,60000000,Scott Stewart,-30863374,Paul Bettany,5,Cory Goodman,29136626
Paramount Pictures,195000000,Michael Bay,157390543,Shia LaBeouf,6,Ehren Kruger,352390543
Regency Enterprises,40000000,Andrew Niccol,-2479905,Justin Timberlake,10,Andrew Niccol,37520095
Twentieth Century Fox Film Corporation,50000000,Cameron Crowe,25624550,Matt Damon,12,Aline Brosh McKenna,75624550
Mediapro,17000000,Woody Allen,39816662,Owen Wilson,6,Woody Allen,56816662
Summit Entertainment,32000000,Duncan Jones,22712227,Jake Gyllenhaal,4,Ben Ripley,54712227
Paramount Pictures,145000000,Brad Bird,64397903,Tom Cruise,12,Bruce Geller,209397903
Columbia Pictures,80000000,Dennis Dugan,23028109,Adam Sandler,2,Allan Loeb,103028109
Lionsgate,40000000,Brad Furman,18009200,Matthew McConaughey,3,John Romano,58009200
New Line Cinema,35000000,Seth Gordon,82538559,Jason Bateman,7,Michael Markowitz,117538559
DreamWorks,60000000,D.J. Caruso,-4899563,Alex Pettyfer,2,Alfred Gough,55100437
See-Saw Films,6500000,Steve McQueen,-2499696,Michael Fassbender,3,Steve McQueen,4000304
Dimension Films,40000000,Wes Craven,-1819072,Neve Campbell,4,Kevin Williamson,38180928
Screen Gems,35000000,Will Gluck,20802754,Mila Kunis,7,Keith Merryman,55802754
Columbia Pictures,20000000,Jake Kasdan,80292856,Cameron Diaz,6,Gene Stupnitsky,100292856
Paramount Pictures,150000000,Martin Scorsese,-76135493,Asa Butterfield,11,John Logan,73864507
Snoot Entertainment,1000000,Adam Wingard,17474268,Sharni Vinson,8,Simon Barrett,18474268
Columbia Pictures,50000000,Bennett Miller,25605492,Brad Pitt,9,Steven Zaillian,75605492
Focus Features,15000000,Lone Scherfig,-1156229,Anne Hathaway,8,David Nicholls,13843771
Paramount Pictures,25000000,Ivan Reitman,45662220,Natalie Portman,1,Elizabeth Meriwether,70662220
Summit Entertainment,110000000,Bill Condon,171287133,Kristen Stewart,11,Melissa Rosenberg,281287133
BBC Films,7000000,Lynne Ramsay,-5261308,Tilda Swinton,1,Lynne Ramsay,1738692
Warner Bros.,125000000,Guy Ritchie,61848418,Robert Downey Jr.,12,Michele Mulroney,186848418
Zentropa Entertainments,7400000,Lars von Trier,-4370130,Kirsten Dunst,7,Lars von Trier,3029870
Universal Pictures,125000000,Justin Lin,84837675,Vin Diesel,4,Chris Morgan,209837675
Focus Features,30000000,Joe Wright,10259119,Saoirse Ronan,4,Seth Lochhead,40259119
Universal Pictures,50200000,George Nolfi,12295645,Matt Damon,3,George Nolfi,62495645
Blue Haze Entertainment,13000000,Pedro Almodóvar,-9814188,Antonio Banderas,12,Thierry Jonquet,3185812
Open Road Films (II),25000000,Joe Carnahan,26580136,Liam Neeson,1,Joe Carnahan,51580136
DreamWorks,110000000,Shawn Levy,-24531492,Hugh Jackman,10,John Gatins,85468508
Paramount Pictures,135000000,Gore Verbinski,-11522393,Johnny Depp,3,John Logan,123477607
Code Red,6000000,Lance Daly,-5995894,Orlando Bloom,8,John Enbom,4106
Morgan Creek Productions,38000000,Matthijs van Heijningen Jr.,-21071330,Mary Elizabeth Winstead,10,Eric Heisserer,16928670
Millennium Films,90000000,Marcus Nispel,-68704979,Jason Momoa,8,Thomas Dean Donnelly,21295021
Cottonwood Pictures,32000000,Terrence Malick,-18696681,Brad Pitt,10,Terrence Malick,13303319
Fox Searchlight Pictures,20000000,Alexander Payne,62584160,George Clooney,12,Alexander Payne,82584160
Universal Pictures,40000000,Greg Mottola,-2587055,Simon Pegg,3,Simon Pegg,37412945
Universal Pictures,52000000,David Dobkin,-14918525,Jason Bateman,8,Jon Lucas,37081475
Warner Bros.,60000000,Steven Soderbergh,15658097,Matt Damon,9,Scott Z. Burns,75658097
Asghar Farhadi Productions,500000,Asghar Farhadi,6598492,Payman Maadi,4,Asghar Farhadi,7098492
Paramount Pictures,24000000,Craig Brewer,27802742,Kenny Wormald,10,Dean Pitchford,51802742
Lionsgate,35000000,John Singleton,-6912845,Taylor Lautner,9,Shawn Christensen,28087155
Voltage Pictures,11000000,William Friedkin,-9012238,Matthew McConaughey,6,Tracy Letts,1987762
Enticing Entertainment,18000000,Sean McNamara,25853424,AnnaSophia Robb,4,Sean McNamara,43853424
Summit Entertainment,75000000,Paul W.S. Anderson,-54622087,Logan Lerman,10,Alex Litvak,20377913
Summit Entertainment,8000000,Jonathan Levine,27014192,Joseph Gordon-Levitt,9,Will Reiser,35014192
New Line Cinema,36000000,Bobby Farrelly,9060734,Owen Wilson,2,Pete Jones,45060734
Warner Bros.,80000000,Todd Phillips,174464305,Bradley Cooper,5,Craig Mazin,254464305
Walt Disney Pictures,200000000,John Lasseter,-8547604,Owen Wilson,6,John Lasseter,191452396
Pt. Merantau Films,1100000,Gareth Evans,3005123,Iko Uwais,4,Gareth Evans,4105123
Columbia Pictures,135000000,Steven Spielberg,-57408169,Jamie Bell,12,Hergé,77591831
EuropaCorp,40000000,Olivier Megaton,-3334146,Zoe Saldana,8,Luc Besson,36665854
Universal Pictures,49900000,David Gordon Green,-28303555,Danny McBride,4,Danny McBride,21596445
DreamWorks,66000000,Steven Spielberg,13884879,Jeremy Irvine,12,Lee Hall,79884879
Universal Pictures,45000000,Oliver Parker,-36694030,Rowan Atkinson,10,Hamish McColl,8305970
CBS Films,40000000,Simon West,-10878502,Jason Statham,1,Richard Wenk,29121498
Columbia Pictures,12500000,George Clooney,28462534,Paul Giamatti,10,George Clooney,40962534
Studio 37,15000000,Michel Hazanavicius,29671682,Jean Dujardin,1,Michel Hazanavicius,44671682
Imagine Entertainment,35000000,Clint Eastwood,2306030,Leonardo DiCaprio,11,Dustin Lance Black,37306030
Columbia Pictures,70000000,Jonathan Liebesman,13552429,Aaron Eckhart,3,Christopher Bertolini,83552429
Before The Door Pictures,3500000,J.C. Chandor,1854039,Zachary Quinto,9,J.C. Chandor,5354039
DreamWorks,30000000,Craig Gillespie,-11701351,Anton Yelchin,8,Marti Noxon,18298649
Twentieth Century Fox Animation,90000000,Carlos Saldanha,53619809,Jesse Eisenberg,4,Carlos Saldanha,143619809
Columbia Pictures,110000000,Raja Gosnell,32614158,Hank Azaria,7,J. David Stem,142614158
Paramount Vantage,250000,Drake Doremus,3163908,Felicity Jones,1,Drake Doremus,3413908
StudioCanal,13000000,Joe Cornish,-11975825,John Boyega,5,Joe Cornish,1024175
Hydraulx,5000000,Jeff Nichols,-3270031,Michael Shannon,11,Jeff Nichols,1729969
Dark Castle Entertainment,30000000,Jaume Collet-Serra,33686397,Liam Neeson,2,Oliver Butcher,63686397
CBS Films,17000000,Daniel Barnz,10865571,Alex Pettyfer,3,Daniel Barnz,27865571
New Line Cinema,40000000,Steven Quale,2587643,Nicholas D'Agosto,8,Eric Heisserer,42587643
DreamWorks Animation,150000000,Jennifer Yuh Nelson,15249063,Jack Black,5,Jonathan Aibel,165249063
Harvey Boys The,4000000,Kevin Smith,-2895318,Michael Parks,9,Kevin Smith,1104682
Artists Public Domain,100000,Mike Cahill,1216074,Brit Marling,10,Mike Cahill,1316074
Columbia Pictures,57000000,Mark Neveldine,-5225998,Nicolas Cage,2,Scott M. Gimple,51774002
Warner Bros.,42000000,Catherine Hardwicke,-4337838,Amanda Seyfried,3,David Leslie Johnson,37662162
Screen Gems,16000000,Christian E. Christiansen,21300107,Minka Kelly,2,Sonny Mallhi,37300107
Fox 2000 Pictures,38000000,Francis Lawrence,20709717,Robert Pattinson,4,Richard LaGravenese,58709717
Relativity Media,23000000,Steven Soderbergh,-4057604,Gina Carano,1,Lem Dobbs,18942396
Regency Enterprises,20000000,Mark Mylod,-5991807,Anna Faris,9,Gabrielle Allan,14008193
Screen Gems,25000000,Rod Lurie,-14675559,James Marsden,9,Rod Lurie,10324441
Rogue Pictures,23000000,Michael Dowse,-16076109,Topher Grace,3,Jackie Filgo,6923891
Universal Pictures,75000000,Brett Ratner,3046570,Eddie Murphy,11,Adam Cooper,78046570
Summit Entertainment,50000000,Patrick Lussier,-39293214,Nicolas Cage,2,Todd Farmer,10706786
Blueprint Pictures,10000000,John Madden,36412041,Judi Dench,5,Ol Parker,46412041
Cliffjack Motion Pictures,55000000,Jim Sheridan,-33716560,Daniel Craig,9,David Loucka,21283440
New Line Cinema,56000000,Garry Marshall,-1455362,Sarah Jessica Parker,12,Katherine Fugate,54544638
Universal Pictures,30000000,Tom Hanks,5608245,Tom Hanks,7,Tom Hanks,35608245
Omnilab Media,70000000,Gary McKendry,-44875014,Jason Statham,9,Matt Sherring,25124986
New Line Cinema,37000000,Mikael Håfström,-3952367,Colin O'Donoghue,1,Michael Petroni,33047633
Dimension Films,27000000,Robert Rodriguez,11538188,Jessica Alba,8,Robert Rodriguez,38538188
Fox 2000 Pictures,20000000,Thomas Bezucha,3186769,Selena Gomez,7,Thomas Bezucha,23186769
Reprisal Films,6000000,John Michael McDonagh,-640226,Brendan Gleeson,7,John Michael McDonagh,5359774
Warner Bros.,40000000,Stephen Daldry,-8152119,Thomas Horn,1,Eric Roth,31847881
Alcon Entertainment,35000000,Luke Greenfield,4046489,Ginnifer Goodwin,5,Jennie Snyder Urman,39046489
GK Films,45000000,Bruce Robinson,-31899958,Johnny Depp,10,Bruce Robinson,13100042
Pathé,13000000,Phyllida Lloyd,17017992,Meryl Streep,1,Abi Morgan,30017992
SBS Productions,25000000,Roman Polanski,-22452953,Jodie Foster,4,Yasmina Reza,2547047
Dark Sky Films,750000,Ti West,-672499,Sara Paxton,4,Ti West,77501
Universal Pictures,70000000,Ron Howard,-21524710,Vince Vaughn,1,Allan Loeb,48475290
Columbia Pictures,28000000,Ruben Fleischer,9053924,Jesse Eisenberg,8,Michael Diliberti,37053924
Columbia Pictures,120000000,Michel Gondry,-21219958,Seth Rogen,1,Seth Rogen,98780042
Millennium Films,35000000,Joel Schumacher,-34983184,Nicolas Cage,5,Karl Gajdusek,16816
Walt Disney Pictures,45000000,James Bobin,43631237,Amy Adams,11,Jason Segel,88631237
Summit Entertainment,30000000,Chris Gorak,-8573195,Emile Hirsch,12,Jon Spaihts,21426805
Atlas Entertainment,40000000,Dominic Sena,-15172772,Nicolas Cage,1,Bragi F. Schut,24827228
Touchstone Pictures,36000000,Kelly Asbury,63967670,James McAvoy,2,Rob Sprackling,99967670
Anchor Bay Films,12000000,Jonathan Hensleigh,-10812289,Ray Stevenson,5,Jonathan Hensleigh,1187711
Semtex Films,15000000,Madonna,-14416545,Abbie Cornish,7,Madonna,583455
Mandalay Vision,5000000,Richard Linklater,4203192,Jack Black,6,Skip Hollandsworth,9203192
Focus Features,25000000,Kevin Macdonald,-5509959,Channing Tatum,2,Jeremy Brock,19490041
Relativity Media,30000000,Marc Forster,-29461310,Gerard Butler,2,Jason Keller,538690
Elle Driver,2000000,Chris Kentis,10555230,Elizabeth Olsen,3,Gustavo Hernández,12555230
Columbia Pictures,79000000,Dennis Dugan,-4841843,Adam Sandler,11,Steve Koren,74158157
Endgame Entertainment,17000000,Roger Donaldson,-16958919,Nicolas Cage,1,Todd Hickey,41081
DreamWorks Animation,130000000,Chris Miller,19260504,Antonio Banderas,10,Tom Wheeler,149260504
Paramount Pictures,12000000,Jason Reitman,4311571,Charlize Theron,12,Diablo Cody,16311571
Universal Pictures,63000000,Tim Hill,45085305,Russell Brand,4,Cinco Paul,108085305
Incentive Filmed Entertainment,25000000,David R. Ellis,-6127478,Sara Paxton,9,Will Hayes,18872522
Alcon Entertainment,37000000,Charles Martin Smith,35286779,Morgan Freeman,9,Karen Janszen,72286779
Columbia Pictures,80000000,Frank Coraci,360843,Kevin James,7,Nick Bakay,80360843
Summit Entertainment,21000000,Jodie Foster,-20029184,Mel Gibson,6,Kyle Killen,970816
Twentieth Century Fox Film Corporation,55000000,Mark Waters,13224452,Jim Carrey,6,Sean Anders,68224452
Columbia Pictures,30000000,Roland Emmerich,-25536708,Rhys Ifans,12,John Orloff,4463292
Beijing New Picture Film Co.,94000000,Yimou Zhang,-93990787,Christian Bale,12,Heng Liu,9213
Instinctive Film,3000000,Xavier Gens,-2978000,Lauren German,4,Karl Mueller,22000
Lightstream Entertainment,12000000,Oren Moverman,-11030761,Woody Harrelson,2,James Ellroy,969239
Fox 2000 Pictures,21000000,David Bowers,31698535,Zachary Gordon,3,Gabe Sachs,52698535
Walt Disney Pictures,30000000,Stephen J. Anderson,-3307154,Jim Cummings,7,Stephen J. Anderson,26692846
Rhombus Media,3000000,Jason Eisener,-2296998,Rutger Hauer,5,John Davies,703002
Warner Bros.,135000000,George Miller,-70993534,Elijah Wood,11,George Miller,64006466
Universal Pictures,30000000,Alister Grierson,-6929955,Rhys Wakefield,2,John Garvin,23070045
Paramount Pictures,5000000,Henry Joost,99007828,Chloe Csengery,10,Christopher Landon,104007828
Red Granite Pictures,10000000,Jennifer Westfeldt,-2749946,Jennifer Westfeldt,3,Jennifer Westfeldt,7250054
Big Beach Films,5000000,Jesse Peretz,19814830,Paul Rudd,8,Jesse Peretz,24814830
New Line Cinema,19000000,Todd Strauss-Schulson,16033759,Kal Penn,11,Jon Hurwitz,35033759
Fox Searchlight Pictures,14000000,Kenneth Lonergan,-13953505,Anna Paquin,6,Kenneth Lonergan,46495
Mockingbird Pictures,8000000,Rodrigo García,-4985304,Glenn Close,6,Gabriella Prekop,3014696
Dimension Films,5000000,Gonzalo López-Gallego,12686929,Warren Christie,9,Brian Miller,17686929
Annapurna Productions,7000000,Aaron Harvey,-6998113,Malin Akerman,1,Aaron Harvey,1887
Fox 2000 Pictures,75000000,Mike Mitchell,58110742,Justin Long,12,Jonathan Aibel,133110742
Carver Films,2000000,Justin Kurzel,-1991988,Lucas Pittaway,5,Shaun Grant,8012
Warner Bros.,40000000,Jason Winer,-6964603,Russell Brand,4,Peter Baynham,33035397
TriStar Pictures,2000000,Alex Kendrick,32522221,Alex Kendrick,9,Alex Kendrick,34522221
Fox 2000 Pictures,41000000,David Frankel,-33795862,Owen Wilson,10,Howard Franklin,7204138
Rickshaw Productions,8000000,Joe Nussbaum,2130219,Aimee Teegarden,4,Katie Wech,10130219
GK Films,13000000,Angelina Jolie,-12696123,Zana Marjanovic,2,Angelina Jolie,303877
Foresight Unlimited,10000000,Matthew Chapman,-9994824,Charlie Hunnam,5,Matthew Chapman,5176
Eros International,10920000,Imtiaz Ali,-9934088,Ranbir Kapoor,11,Imtiaz Ali,985912
Atlas Productions,20000000,Paul Johansson,-15247647,Taylor Schilling,4,Brian Patrick O'Toole,4752353
Safran Company The,5000000,Rob Minkoff,-4998902,Patrick Dempsey,5,Jon Lucas,1098
Antena 3 Films,13000000,Juan Carlos Fresnadillo,-12930864,Clive Owen,4,Nicolás Casariego,69136
TriStar Pictures,6600000,Salim Akil,30695394,Paula Patton,5,Elizabeth Hunter,37295394
Studio Ghibli,22000000,Gorô Miyazaki,-20997105,Sarah Bolger,7,Tetsurô Sayama,1002895
Regency Enterprises,32000000,John Whitesell,5915414,Martin Lawrence,2,Matt Fogel,37915414
Excel Entertainment,16700000,Farhan Akhtar,-13019694,Shah Rukh Khan,12,Farhan Akhtar,3680306
Magic Violet,8000000,Geoffrey Fletcher,-7982814,Saoirse Ronan,6,Geoffrey Fletcher,17186
Warner Bros.,250000000,Christopher Nolan,198139099,Christian Bale,7,Jonathan Nolan,448139099
The Weinstein Company,100000000,Quentin Tarantino,62805434,Jamie Foxx,12,Quentin Tarantino,162805434
Lionsgate,78000000,Gary Ross,330010692,Jennifer Lawrence,3,Gary Ross,408010692
Marvel Studios,220000000,Joss Whedon,403357910,Robert Downey Jr.,5,Joss Whedon,623357910
Twentieth Century Fox Film Corporation,130000000,Ridley Scott,-3522916,Noomi Rapace,6,Jon Spaihts,126477084
New Line Cinema,180000000,Peter Jackson,123003568,Martin Freeman,12,Fran Walsh,303003568
Brownstone Productions (II),17000000,Jason Moore,48001093,Anna Kendrick,10,Kay Cannon,65001093
Paramount Pictures,60000000,Christopher McQuarrie,20070736,Tom Cruise,12,Lee Child,80070736
Summit Entertainment,13000000,Stephen Chbosky,4738570,Logan Lerman,10,Stephen Chbosky,17738570
Cloud Atlas Productions,102000000,Tom Tykwer,-74891728,Tom Hanks,10,David Mitchell,27108272
Summit Entertainment,120000000,Bill Condon,172298923,Kristen Stewart,11,Melissa Rosenberg,292298923
Lionsgate,30000000,Drew Goddard,12073277,Kristen Connolly,4,Joss Whedon,42073277
Working Title Films,61000000,Tom Hooper,87809770,Hugh Jackman,12,William Nicholson,148809770
Indian Paintbrush,16000000,Wes Anderson,29512466,Jared Gilman,6,Wes Anderson,45512466
Eon Productions,200000000,Sam Mendes,104360277,Daniel Craig,11,Ian Fleming,304360277
Columbia Pictures,42000000,Phil Lord,96447667,Jonah Hill,3,Michael Bacall,138447667
Universal Pictures,209000000,Peter Berg,-143577375,Alexander Skarsgård,5,Jon Hoeber,65422625
Endgame Entertainment,30000000,Rian Johnson,36486205,Joseph Gordon-Levitt,9,Rian Johnson,66486205
Columbia Pictures,40000000,Kathryn Bigelow,55720716,Jessica Chastain,1,Mark Boal,95720716
Roth Films,170000000,Rupert Sanders,-14667619,Kristen Stewart,6,Evan Daugherty,155332381
The Weinstein Company,21000000,David O. Russell,111092958,Bradley Cooper,12,David O. Russell,132092958
Universal Pictures,50000000,Jon Hurwitz,7011521,Jason Biggs,4,Jon Hurwitz,57011521
Warner Bros.,150000000,Tim Burton,-70272851,Johnny Depp,5,Seth Grahame-Smith,79727149
Columbia Pictures,230000000,Marc Webb,32030663,Andrew Garfield,7,James Vanderbilt,262030663
Sidney Kimmel Entertainment,15000000,Derek Cianfrance,6383298,Ryan Gosling,4,Derek Cianfrance,21383298
Warner Bros.,44500000,Ben Affleck,91525503,Ben Affleck,10,Chris Terrio,136025503
Danmarks Radio (DR),3800000,Thomas Vinterberg,-3112815,Mads Mikkelsen,12,Tobias Lindholm,687185
Iron Horse Entertainment (II),7000000,Steven Soderbergh,106721571,Channing Tatum,6,Reid Carolin,113721571
Universal Pictures,125000000,Tony Gilroy,-11796130,Jeremy Renner,8,Tony Gilroy,113203870
Mediaset España,45000000,J.A. Bayona,-25980118,Naomi Watts,1,Sergio G. Sánchez,19019882
Muse Productions,5000000,Harmony Korine,9123773,Vanessa Hudgens,3,Harmony Korine,14123773
Walt Disney Animation Studios,165000000,Rich Moore,24422889,John C. Reilly,11,Rich Moore,189422889
Walt Disney Pictures,185000000,Mark Andrews,52283207,Kelly Macdonald,6,Brenda Chapman,237283207
DNA Films,35000000,Pete Travis,-21585286,Karl Urban,9,John Wagner,13414714
The Weinstein Company,26000000,John Hillcoat,11400127,Tom Hardy,8,Nick Cave,37400127
Alliance Films,3000000,Scott Derrickson,45086903,Ethan Hawke,10,Scott Derrickson,48086903
Walt Disney Pictures,250000000,Andrew Stanton,-176921900,Taylor Kitsch,3,Andrew Stanton,73078100
DreamWorks,65000000,Steven Spielberg,117207973,Daniel Day-Lewis,11,Tony Kushner,182207973
New Line Cinema,75000000,Adam Shankman,-36481387,Julianne Hough,6,Justin Theroux,38518613
Columbia Pictures,225000000,Barry Sonnenfeld,-45979146,Will Smith,5,Etan Cohen,179020854
Paramount Pictures,31000000,Robert Zemeckis,62772375,Denzel Washington,11,John Gatins,93772375
Universal Pictures,50000000,Seth MacFarlane,168815487,Mark Wahlberg,6,Seth MacFarlane,218815487
The Weinstein Company,32000000,Paul Thomas Anderson,-15622726,Philip Seymour Hoffman,9,Paul Thomas Anderson,16377274
Exclusive Media Group,7000000,David Ayer,34003371,Jake Gyllenhaal,9,David Ayer,41003371
Fox 2000 Pictures,120000000,Ang Lee,4987023,Suraj Sharma,11,Yann Martel,124987023
Columbia Pictures,85000000,Genndy Tartakovsky,63313048,Adam Sandler,9,Peter Baynham,148313048
Overbrook Entertainment,65000000,McG,-10239209,Reese Witherspoon,2,Timothy Dowling,54760791
Columbia Pictures,70000000,Sean Anders,-33068911,Adam Sandler,6,David Caspe,36931089
Screen Gems,30000000,Michael Sucsy,95014030,Rachel McAdams,2,Abby Kohn,125014030
Green Hat Films,12000000,Nima Nourizadeh,42731865,Thomas Mann,3,Matt Drake,54731865
Total Recall,125000000,Len Wiseman,-66122031,Colin Farrell,8,Kurt Wimmer,58877969
Ixtlan,45000000,Oliver Stone,2382068,Aaron Taylor-Johnson,7,Shane Salerno,47382068
Paramount Pictures,65000000,Larry Charles,-5349778,Sacha Baron Cohen,5,Sacha Baron Cohen,59650222
CBS Films,15000000,Martin McDonagh,24049,Colin Farrell,10,Martin McDonagh,15024049
Samuel Goldwyn Films,2000000,Jon Kasdan,-1982939,Dylan O'Brien,2,Jon Kasdan,17061
Apatow Productions,35000000,Judd Apatow,32544505,Paul Rudd,12,Judd Apatow,67544505
Warner Bros.,25000000,Scott Hicks,35457138,Zac Efron,4,Will Fetters,60457138
DreamWorks Animation,145000000,Peter Ramsey,-41587242,Hugh Jackman,11,David Lindsay-Abaire,103412758
Warner Bros.,150000000,Jonathan Liebesman,-66329917,Sam Worthington,3,Dan Mazeau,83670083
New Line Cinema,79000000,Brad Peyton,24860290,Josh Hutcherson,2,Brian Gunn,103860290
Davis-Films,20000000,Michael J. Bassett,-2470843,Adelaide Clemens,10,Michael J. Bassett,17529157
Universal Pictures,85000000,Daniel Espinosa,41373434,Denzel Washington,2,David Guggenheim,126373434
Fox Searchlight Pictures,8000000,Jonathan Dayton,-5459894,Paul Dano,11,Zoe Kazan,2540106
Lionsgate,10000000,Jeff Nichols,11590086,Matthew McConaughey,5,Jeff Nichols,21590086
Screen Gems,70000000,Måns Mårlind,-7678961,Kate Beckinsale,1,Len Wiseman,62321039
Millennium Films,100000000,Simon West,-14982599,Sylvester Stallone,8,Richard Wenk,85017401
Constantin Film International,65000000,Paul W.S. Anderson,-22654469,Milla Jovovich,9,Paul W.S. Anderson,42345531
Lionsgate,40000000,Kirk Jones,1152203,Cameron Diaz,5,Shauna Cross,41152203
EuropaCorp,45000000,Olivier Megaton,94854287,Liam Neeson,10,Luc Besson,139854287
Gary Sanchez Productions,3000000,Leslye Headland,-2552046,Kirsten Dunst,7,Leslye Headland,447954
Twentieth Century Fox Film Corporation,12000000,Josh Trank,52575175,Dane DeHaan,2,Max Landis,64575175
Cross Creek Pictures,17000000,James Watkins,37333290,Daniel Radcliffe,2,Susan Hill,54333290
Universal Pictures,30000000,Nicholas Stoller,-1164472,Jason Segel,4,Jason Segel,28835528
Arcade Pictures,15000000,RZA,634090,Russell Crowe,11,RZA,15634090
Abraham Productions,69000000,Timur Bekmambetov,-31480861,Benjamin Walker,6,Seth Grahame-Smith,37519139
Summit Entertainment,20000000,Mabrouk El Mechri,-16250939,Henry Cavill,9,Scott Wiper,3749061
Relativity Media,6900000,Mark Tonderai,24711916,Jennifer Lawrence,9,David Loucka,31611916
MK2 Productions,25000000,Walter Salles,-24282247,Sam Riley,5,Jack Kerouac,717753
Also Known As Pictures,6000000,Brian Klugman,5494838,Bradley Cooper,9,Brian Klugman,11494838
FilmDistrict,65000000,Dan Bradley,-20193217,Chris Hemsworth,11,Carl Ellsworth,44806783
Bleiberg Entertainment,10000000,Ariel Vromen,-8060559,Michael Shannon,10,Morgan Land,1939441
Universal Pictures,70000000,Chris Renaud,144030500,Zac Efron,3,Dr. Seuss,214030500
Intrepid Pictures,26000000,James McTeigue,-9991728,John Cusack,4,Hannah Shakespeare,16008272
Summit Entertainment,42000000,Asger Leth,-23380000,Sam Worthington,1,Pablo F. Fenjves,18620000
La Petite Reine,6000000,Franck Khalfoun,-5979449,Elijah Wood,1,Alexandre Aja,20551
Focus Features,10000000,Lorene Scafaria,-3380827,Steve Carell,6,Lorene Scafaria,6619173
Double Feature Films,11000000,Lisa Azuelos,-10953500,Miley Cyrus,9,Lisa Azuelos,46500
Relativity Media,85000000,Tarsem Singh,-20064833,Lily Collins,3,Marc Klein,64935167
EuropaCorp,20000000,James Mather,-5673136,Guy Pearce,4,Stephen St. Leger,14326864
Focus Features,60000000,Chris Butler,-3996949,Kodi Smit-McPhee,8,Chris Butler,56003051
Warner Bros.,60000000,Robert Lorenz,-24236863,Clint Eastwood,9,Randy Brown,35763137
Lakeshore Entertainment,40000000,Julie Anne Robinson,-13585473,Katherine Heigl,1,Stacy Sherman,26414527
Plan B Entertainment,15000000,Andrew Dominik,26056,Brad Pitt,11,Andrew Dominik,15026056
Blue Sky Studios,95000000,Steve Martino,66321843,Ray Romano,7,Michael Berg,161321843
Columbia Pictures,42000000,Frank Coraci,3290318,Kevin James,10,Allan Loeb,45290318
Dimension Films,5000000,John Gulager,-4623488,Danielle Panabaker,5,Patrick Melton,376512
IM Global,30000000,Boaz Yakin,-12857920,Jason Statham,4,Boaz Yakin,17142080
Relativity Media,12000000,Mike McCoy,58012847,Alex Veadov,2,Kurt Johnstad,70012847
Alliance,2500000,Rob Zombie,-1336492,Sheri Moon Zombie,4,Rob Zombie,1163508
Millennium Films,35000000,Simon West,-34695682,Nicolas Cage,4,David Guggenheim,304318
SBS Productions,20000000,Brian De Palma,-19908814,Rachel McAdams,8,Brian De Palma,91186
Universal Pictures,25000000,Baltasar Kormákur,41528000,Mark Wahlberg,1,Aaron Guzikowski,66528000
Millennium Films,12500000,Lee Daniels,-11807360,Matthew McConaughey,9,Peter Dexter,692640
Les Films du Losange,8900000,Michael Haneke,-2160508,Jean-Louis Trintignant,9,Michael Haneke,6739492
Ghost House Pictures,14000000,Ole Bornedal,35130154,Natasha Calis,8,Juliet Snowden,49130154
DreamWorks Animation,145000000,Eric Darnell,71391482,Ben Stiller,6,Eric Darnell,216391482
Walt Disney Pictures,39000000,Tim Burton,-3708932,Winona Ryder,10,Leonard Ripps,35291068
Twentieth Century Fox Film Corporation,68000000,Akiva Schaffer,-32647000,Ben Stiller,7,Jared Stern,35353000
Screen Gems,12000000,Tim Story,79547205,Chris Brown,4,Keith Merryman,91547205
Warner Bros.,95000000,Jay Roach,-8092254,Will Ferrell,8,Chris Henchy,86907746
DreamWorks,16000000,Alex Kurtzman,-3587614,Chris Pine,6,Alex Kurtzman,12412386
FilmDistrict,750000,Colin Trevorrow,3260957,Aubrey Plaza,10,Derek Connolly,4010957
Enderby Entertainment,2500000,Stephen Elliott,-2497240,Ashley Hinshaw,8,Stephen Elliott,2760
LD Entertainment,10000000,Marcus Dunstan,-3157942,Josh Stewart,11,Patrick Melton,6842058
Offspring Entertainment,33000000,Scott Speer,2074677,Kathryn McCormick,7,Amanda Brody,35074677
LD Entertainment,10000000,Henry Alex Rubin,-2564050,Jason Bateman,7,Andrew Stern,7435950
Monsterfoot Productions,25000000,Peter Hedges,26853450,Jennifer Garner,8,Peter Hedges,51853450
Bad Cop Bad Cop Film Productions,270000,Craig Zobel,48622,Ann Dowd,9,Craig Zobel,318622
Recorded Picture Company (RPC),16600000,Joachim Rønning,-15082590,Pål Sverre Hagen,4,Petter Skavlan,1517410
Lionsgate,12000000,Nicholas Jarecki,-4081717,Richard Gere,9,Nicholas Jarecki,7918283
Upside Down Films,60000000,Juan Solanas,-59897882,Jim Sturgess,5,Juan Solanas,102118
Columbia Pictures,35000000,David Koepp,-14724554,Joseph Gordon-Levitt,8,David Koepp,20275446
IM Global,55000000,Walter Hill,-45516179,Sylvester Stallone,2,Alessandro Camon,9483821
Magnolia Pictures,12000000,Stefan Ruzowitzky,-11934196,Eric Bana,1,Zach Dean,65804
Block / Hanson,35000000,Rob Cohen,-9111588,Tyler Perry,10,Marc Moss,25888412
Fox Searchlight Pictures,1000000,Ben Lewin,5002451,John Hawkes,11,Ben Lewin,6002451
Alcon Entertainment,1000000,Bradley Parker,17119640,Jesse McCartney,5,Oren Peli,18119640
Cinereach,1800000,Benh Zeitlin,10995746,Quvenzhané Wallis,2,Lucy Alibar,12795746
Fox 2000 Pictures,22000000,David Bowers,27008662,Zachary Gordon,8,Maya Forbes,49008662
H2O Motion Pictures,12000000,David Weaver,-11998256,Samuel L. Jackson,4,Elan Mastai,1744
Voltage Pictures,2000000,Robert Redford,3132442,Robert Redford,4,Lem Dobbs,5132442
Alfama Films,20500000,David Cronenberg,-19756364,Robert Pattinson,5,David Cronenberg,743636
Exclusive Media Group,2000000,David Palmer,11746550,Dax Shepard,8,Dax Shepard,13746550
Twentieth Century Fox Film Corporation,58000000,Anthony Hemingway,-8123623,Cuba Gooding Jr.,1,John Ridley,49876377
Lionsgate,15000000,Fisher Stevens,-11698954,Al Pacino,2,Noah Haidle,3301046
Eclectic Pictures,35000000,Gabriele Muccino,-21898858,Gerard Butler,12,Robbie Fox,13101142
Fox 2000 Pictures,20000000,Michael Apted,-13997244,Jonny Weston,10,Kario Salem,6002756
Dog Run Pictures,2500000,Jake Schreier,825638,Peter Sarsgaard,9,Christopher Ford,3325638
Universal Pictures,40000000,Ken Kwapis,-19886035,Drew Barrymore,2,Jack Amiel,20113965
Focus Features,15000000,Gus Van Sant,-7402102,Matt Damon,1,John Krasinski,7597898
Milk & Media,2900000,Ryûhei Kitamura,-2827860,Luke Evans,5,David Cohen,72140
Paramount Pictures,14000000,Josh Schwartz,-4597590,Victoria Justice,10,Max Werner,9402410
Paramount Pictures,5000000,Henry Joost,48921300,Stephen Dunham,10,Christopher Landon,53921300
Columbia Pictures,55000000,Peter Lord,-23948874,Hugh Grant,4,Gideon Defoe,31051126
Columbia Pictures,30000000,David Frankel,33536011,Meryl Streep,8,Vanessa Taylor,63536011
Prototype,750000,William Brent Bell,52511944,Fernanda Andrade,1,William Brent Bell,53261944
Red Crown Productions,6000000,Scott McGehee,-4935000,Julianne Moore,5,Nancy Doyne,1065000
Twentieth Century Fox Film Corporation,25000000,Andy Fickman,52267296,Billy Crystal,12,Lisa Addario,77267296
AdScott Pictures,850000,Jamie Travis,393961,Ari Graynor,11,Lauren Miller,1243961
Headline Pictures,11000000,Dustin Hoffman,7390117,Maggie Smith,3,Ronald Harwood,18390117
Paramount Pictures,40000000,Anne Fletcher,-2865785,Barbra Streisand,12,Dan Fogelman,37134215
Foresight Unlimited,11500000,John Hyams,-11494540,Jean-Claude Van Damme,10,John Hyams,5460
DreamWorks,40000000,Brian Robbins,-21561851,Eddie Murphy,3,Steve Koren,18438149
NALA Films,6000000,Matt Piedmont,-104762,Will Ferrell,5,Andrew Steele,5895238
Alcon Entertainment,25000000,Todd Graff,5920167,Queen Latifah,1,Todd Graff,30920167
Lucky Monkey Pictures,16000000,Amy Heckerling,-15997036,Alicia Silverstone,11,Amy Heckerling,2964
Super Crispy Entertainment,500000,James Ponsoldt,-124019,Mary Elizabeth Winstead,12,Susan Burke,375981
Warner Bros.,17000000,Todd Lincoln,-12069202,Ashley Greene,8,Todd Lincoln,4930798
Emmett/Furla/Oasis Films (EFO Films),26350000,Stephen Frears,-26329002,Rebecca Hall,6,D.V. DeVincentis,20998
Tyler Perry Company The,20000000,Tyler Perry,45653242,Tyler Perry,6,Tyler Perry,65653242
Filmax,6400000,Paco Plaza,-6391027,Leticia Dolera,4,Luiso Berdejo,8973
Aamir Khan Productions,7395080,Reema Kagti,-4688705,Aamir Khan,11,Farhan Akhtar,2706375
Gold Circle Films,3000000,David Brooks,-2997966,Alice Eve,3,Chris Sparling,2034
Chase Films,20000000,David Chase,-19392673,John Magaro,7,David Chase,607327
2929 Productions,3000000,Tim Heidecker,-2799197,Tim Heidecker,1,Tim Heidecker,200803
Sobras International Pictures,2000000,Nicolás López,-1959821,Eli Roth,6,Nicolás López,40179
Cocktail Film,7980000,Homi Adajania,-6952879,Saif Ali Khan,7,Imtiaz Ali,1027121
Red Granite Pictures,100000000,Martin Scorsese,16900694,Leonardo DiCaprio,12,Terence Winter,116900694
New Line Cinema,20000000,James Wan,117400141,Patrick Wilson,7,Chad Hayes,137400141
Alcon Entertainment,46000000,Denis Villeneuve,15002302,Hugh Jackman,9,Aaron Guzikowski,61002302
Walt Disney Animation Studios,150000000,Chris Buck,250738009,Kristen Bell,11,Jennifer Lee,400738009
Summit Entertainment,75000000,Louis Leterrier,42723989,Jesse Eisenberg,5,Ed Solomon,117723989
Universal Pictures,20000000,Andy Muschietti,51628180,Jessica Chastain,1,Andy Muschietti,71628180
Annapurna Pictures,23000000,Spike Jonze,2568251,Joaquin Phoenix,1,Spike Jonze,25568251
Warner Bros.,225000000,Zack Snyder,66045518,Henry Cavill,6,David S. Goyer,291045518
New Line Cinema,37000000,Rawson Marshall Thurber,113394119,Jason Sudeikis,8,Bob Fisher,150394119
Warner Bros.,105000000,Baz Luhrmann,39840419,Leonardo DiCaprio,5,Baz Luhrmann,144840419
Warner Bros.,190000000,Guillermo del Toro,-88197094,Idris Elba,7,Travis Beacham,101802906
Color Force,130000000,Francis Lawrence,294668047,Jennifer Lawrence,11,Simon Beaufoy,424668047
Columbia Pictures,40000000,David O. Russell,110117807,Christian Bale,12,Eric Warren Singer,150117807
Warner Bros.,100000000,Alfonso Cuarón,174092705,Sandra Bullock,10,Alfonso Cuarón,274092705
Regency Enterprises,20000000,Steve McQueen,36671993,Chiwetel Ejiofor,11,John Ridley,56671993
Paramount Pictures,190000000,J.J. Abrams,38778661,Chris Pine,5,Roberto Orci,228778661
Marvel Studios,200000000,Shane Black,209013994,Robert Downey Jr.,5,Drew Pearce,409013994
Millennium Films,70000000,Antoine Fuqua,28925640,Gerard Butler,3,Creighton Rothenberger,98925640
Universal Pictures,120000000,Joseph Kosinski,-30978265,Tom Cruise,4,Karl Gajdusek,89021735
Truth Entertainment (II),5000000,Jean-Marc Vallée,22298285,Matthew McConaughey,11,Craig Borten,27298285
Translux,12000000,Richard Curtis,3322921,Domhnall Gleeson,11,Richard Curtis,15322921
Paramount Pictures,190000000,Marc Forster,12359711,Brad Pitt,6,Matthew Michael Carnahan,202359711
Warner Bros.,60000000,Ruben Fleischer,-13999097,Sean Penn,1,Will Beall,46000903
Film 44,40000000,Peter Berg,85095601,Mark Wahlberg,1,Peter Berg,125095601
Metro-Goldwyn-Mayer (MGM),30000000,Kimberly Peirce,5266619,Chloë Grace Moretz,10,Lawrence D. Cohen,35266619
Marvel Studios,170000000,Alan Taylor,36362140,Chris Hemsworth,11,Christopher Yost,206362140
Exclusive Media Group,38000000,Ron Howard,-11052376,Daniel Brühl,9,Peter Morgan,26947624
Columbia Pictures,32000000,Evan Goldberg,69470202,James Franco,6,Seth Rogen,101470202
SnowPiercer,39200000,Joon-ho Bong,-34636350,Chris Evans,7,Joon-ho Bong,4563650
Universal Pictures,3000000,James DeMonaco,61473115,Ethan Hawke,6,James DeMonaco,64473115
Universal Pictures,160000000,Justin Lin,78679850,Vin Diesel,5,Chris Morgan,238679850
Worldview Entertainment,6000000,Eli Roth,1192291,Lorenza Izzo,9,Guillermo Amoedo,7192291
Columbia Pictures,80000000,Dennis Dugan,53668525,Adam Sandler,7,Fred Wolf,133668525
Universal Pictures,28000000,Jeff Wadlow,795985,Aaron Taylor-Johnson,8,Jeff Wadlow,28795985
Metro-Goldwyn-Mayer (MGM),225000000,Peter Jackson,33366855,Ian McKellen,12,Fran Walsh,258366855
Alcon Entertainment,60000000,Richard LaGravenese,-40547862,Alice Englert,2,Richard LaGravenese,19452138
Fox 2000 Pictures,25000000,Ridley Scott,-8026285,Michael Fassbender,10,Cormac McCarthy,16973715
TriStar Pictures,17000000,Fede Alvarez,37239856,Jane Levy,4,Fede Alvarez,54239856
Twentieth Century Fox Film Corporation,90000000,Ben Stiller,-31763162,Ben Stiller,12,Steve Conrad,58236838
TriStar Pictures,115000000,Neill Blomkamp,-21949883,Matt Damon,8,Neill Blomkamp,93050117
Universal Pictures,20000000,Edgar Wright,6004851,Simon Pegg,8,Simon Pegg,26004851
Twentieth Century Fox Film Corporation,43000000,Paul Feig,116582188,Sandra Bullock,6,Katie Dippold,159582188
EuropaCorp,30000000,Luc Besson,6918811,Robert De Niro,9,Luc Besson,36918811
Film4,13300000,Jonathan Glazer,-10694961,Scarlett Johansson,3,Walter Campbell,2605039
Universal Pictures,76000000,Pierre Coffin,292061265,Steve Carell,7,Cinco Paul,368061265
Voltage Pictures,3000000,Joseph Gordon-Levitt,21477704,Joseph Gordon-Levitt,9,Joseph Gordon-Levitt,24477704
Constantin Film,60000000,Harald Zwart,-28834579,Lily Collins,8,Jessica Postigo,31165421
Good Universe,30000000,Spike Lee,-27837407,Josh Brolin,11,Garon Tsuchiya,2162593
Paramount Pictures,50000000,Tommy Wirkola,5703475,Jeremy Renner,1,Tommy Wirkola,55703475
Relativity Media,28000000,Lasse Hallström,43349120,Julianne Hough,2,Dana Stevens,71349120
Paramount Pictures,130000000,Jon M. Chu,-7476940,Dwayne Johnson,3,Rhett Reese,122523060
Relativity Media,6000000,Elizabeth Banks,2828771,Emma Stone,1,Rocky Russo,8828771
Summit Entertainment,50000000,Mikael Håfström,-24867772,Sylvester Stallone,10,Miles Chapman,25132228
OddLot Entertainment,110000000,Gavin Hood,-48262809,Harrison Ford,11,Gavin Hood,61737191
Appian Way,22000000,Scott Cooper,-10673164,Christian Bale,12,Brad Ingelsby,11326836
Relativity Media,5000000,Mike Flanagan,22695246,Karen Gillan,4,Mike Flanagan,27695246
Paramount Pictures,26000000,Michael Bay,23875291,Mark Wahlberg,4,Christopher Markus,49875291
Fox Searchlight Pictures,12000000,Chan-wook Park,-10297723,Mia Wasikowska,4,Wentworth Miller,1702277
DreamWorks Animation,135000000,Kirk De Micco,52168425,Nicolas Cage,3,Chris Sanders,187168425
Di Bonaventura Pictures,45000000,Jee-woon Kim,-32949701,Arnold Schwarzenegger,1,Andrew Knauer,12050299
Bellanova Films,50000,James Ward Byrkit,18877,Emily Baldoni,8,James Ward Byrkit,68877
Twentieth Century Fox Film Corporation,120000000,James Mangold,12556852,Hugh Jackman,7,Mark Bomback,132556852
Summit Entertainment,35000000,Jonathan Levine,31380662,Nicholas Hoult,2,Jonathan Levine,66380662
Lionsgate,20000000,John Luessenhop,14341945,Alexandra Daddario,1,Adam Marcus,34341945
Scott Rudin Productions,55000000,Paul Greengrass,52100855,Tom Hanks,10,Billy Ray,107100855
Andrew Lauren Productions (ALP),2500000,James Ponsoldt,4351969,Miles Teller,9,Scott Neustadter,6851969
Green Hat Films,103000000,Todd Phillips,9200072,Bradley Cooper,5,Todd Phillips,112200072
Twentieth Century Fox Film Corporation,58000000,Shawn Levy,-13327236,Vince Vaughn,6,Vince Vaughn,44672764
Walt Disney Pictures,215000000,Gore Verbinski,-125697885,Johnny Depp,7,Justin Haythe,89302115
Walt Disney Pictures,215000000,Sam Raimi,19911825,James Franco,3,Mitchell Kapner,234911825
Gaumont,16000000,Anne Fontaine,-15682875,Naomi Watts,10,Anne Fontaine,317125
Walt Disney Pictures,200000000,Dan Scanlon,68492764,Billy Crystal,6,Dan Scanlon,268492764
Space Rocket Nation,4800000,Nicolas Winding Refn,-4021435,Ryan Gosling,9,Nicolas Winding Refn,778565
Columbia Pictures,150000000,Roland Emmerich,-76896216,Channing Tatum,6,James Vanderbilt,73103784
No Trace Camping,11000000,Michael Dowse,-7547883,Daniel Radcliffe,8,Elan Mastai,3452117
FilmDistrict,5000000,James Wan,78586447,Patrick Wilson,9,Leigh Whannell,83586447
Endgame Entertainment,30000000,Steven Soderbergh,2172757,Rooney Mara,2,Scott Z. Burns,32172757
Fox 2000 Pictures,90000000,Thor Freudenthal,-21440446,Logan Lerman,8,Marc Guggenheim,68559554
Summit Entertainment,84000000,Dean Parisot,-30737440,Bruce Willis,7,Jon Hoeber,53262560
Exclusive Media Group,8000000,John Carney,8170632,Keira Knightley,7,John Carney,16170632
Entertainment One,38000000,David Twohy,4025135,Vin Diesel,9,David Twohy,42025135
Chockstone Pictures,40000000,Andrew Niccol,-13372799,Saoirse Ronan,3,Andrew Niccol,26627201
Steel Mill Pictures,5000000,Jon S. Baird,-4965679,James McAvoy,4,Jon S. Baird,34321
Warner Bros.,40000000,Brian Helgeland,55001343,Chadwick Boseman,4,Brian Helgeland,95001343
Twentieth Century Fox Film Corporation,92000000,John Moore,-24650802,Bruce Willis,2,Skip Woods,67349198
Columbia Pictures,130000000,M. Night Shyamalan,-69477903,Jaden Smith,5,Gary Whitta,60522097
Sycamore Pictures,5000000,Nat Faxon,16501098,Steve Carell,7,Nat Faxon,21501098
H2F Entertainment,175000000,Carl Rinsch,-136637525,Keanu Reeves,12,Chris Morgan,38362475
Gravier Productions,18000000,Woody Allen,15405481,Cate Blanchett,8,Woody Allen,33405481
Follow Through Productions,30000000,Lee Daniels,86632095,Forest Whitaker,8,Danny Strong,116632095
Open Road Films (II),22000000,Gary Fleder,-2216223,Jason Statham,11,Sylvester Stallone,19783777
The Weinstein Company,25000000,John Wells,12738503,Meryl Streep,1,Tracy Letts,37738503
New Line Cinema,195000000,Bryan Singer,-129812397,Nicholas Hoult,3,Darren Lemke,65187603
Universal Pictures,130000000,Robert Schwentke,-96381145,Ryan Reynolds,7,Phil Hay,33618855
Relativity Media,13000000,Jon Lucas,12682380,Miles Teller,3,Jon Lucas,25682380
FilmDistrict,30000000,Niels Arden Oplev,-19119074,Colin Farrell,3,J.H. Wyman,10880926
CBS Films,11000000,Ethan Coen,2235319,Oscar Isaac,1,Joel Coen,13235319
AR Films,20000000,Robert Rodriguez,-11991839,Danny Trejo,10,Kyle Ward,8008161
Recorded Picture Company (RPC),7000000,Jim Jarmusch,-5120466,Tilda Swinton,4,Jim Jarmusch,1879534
Walt Disney Pictures,35000000,John Lee Hancock,48301580,Emma Thompson,12,Kelly Marcel,83301580
Aggregate Films,35000000,Seth Gordon,99506920,Jason Bateman,2,Craig Mazin,134506920
Pathé,20000000,Danny Boyle,-17680813,James McAvoy,5,Joe Ahearne,2319187
Universal Pictures,61000000,Baltasar Kormákur,14612460,Denzel Washington,8,Blake Masters,75612460
Open Road Films (II),12000000,Joshua Michael Stern,4117443,Ashton Kutcher,8,Matt Whiteley,16117443
Faliro House Productions,3000000,Richard Linklater,5114627,Ethan Hawke,6,Richard Linklater,8114627
Exclusive Media Group,15000000,Ric Roman Waugh,27930462,Dwayne Johnson,2,Justin Haythe,42930462
Millennium Films,10000000,Rob Epstein,-9643418,Amanda Seyfried,9,Andy Bellin,356582
American Zoetrope,8000000,Sofia Coppola,-2158954,Katie Chang,6,Sofia Coppola,5841046
Two Ton Films,35000000,Justin Zackham,-13215568,Robert De Niro,4,Justin Zackham,21784432
Incentive Filmed Entertainment,35000000,Taylor Hackford,-17390018,Jason Statham,1,John J. McLaughlin,17609982
Fox 2000 Pictures,19000000,Brian Percival,2488481,Sophie Nélisse,11,Markus Zusak,21488481
Paramount Pictures,50000000,Adam McKay,77352707,Will Ferrell,12,Will Ferrell,127352707
Columbia Pictures,105000000,Raja Gosnell,-33982216,Neil Patrick Harris,7,J. David Stem,71017784
TriStar Pictures,13000000,Brad Anderson,38872378,Halle Berry,3,Richard D'Ovidio,51872378
The Lab of Madness,1066167,Jeremy Saulnier,-808054,Macon Blair,7,Jeremy Saulnier,258113
New Line Cinema,30000000,Don Scardino,-7474079,Steve Carell,3,Jonathan Goldstein,22525921
Voltage Pictures,8500000,Terry Gilliam,-8280562,Christoph Waltz,8,Pat Rushin,219438
CBS Films,28000000,Jon Turteltaub,35914167,Robert De Niro,11,Dan Fogelman,63914167
DJ Films,10900000,Amma Asante,-173370,Gugu Mbatha-Raw,6,Misan Sagay,10726630
Dimension Films,20000000,Malcolm D. Lee,12015787,Simon Rex,4,David Zucker,32015787
The Weinstein Company,12000000,Stephen Frears,25707719,Judi Dench,11,Steve Coogan,37707719
Regency Enterprises,30000000,Brad Furman,-10683354,Ben Affleck,10,Brian Koppelman,19316646
Before The Door Pictures,9000000,J.C. Chandor,-2736330,Robert Redford,11,J.C. Chandor,6263670
Paramount Vantage,12000000,Alexander Payne,5654912,Bruce Dern,1,Bob Nelson,17654912
erbp,50000,Shane Carruth,394098,Amy Seimetz,1,Shane Carruth,444098
Fox Searchlight Pictures,8000000,Nicole Holofcener,9536788,Julia Louis-Dreyfus,10,Nicole Holofcener,17536788
Corsan,28000000,Paul Haggis,-26980962,Liam Neeson,3,Paul Haggis,1019038
Twentieth Century Fox Animation,100000000,Chris Wedge,7518682,Amanda Seyfried,5,James V. Hart,107518682
Touchstone Pictures,26000000,Ken Scott,4664106,Vince Vaughn,11,Ken Scott,30664106
3 Arts Entertainment,1500000,Maggie Carey,1947339,Aubrey Plaza,7,Maggie Carey,3447339
Alliance Films,3500000,Scott Stewart,13911930,Keri Russell,2,Scott Stewart,17411930
Indian Paintbrush,18000000,Jason Reitman,-4637692,Kate Winslet,1,Jason Reitman,13362308
Lionsgate,20000000,Steven Knight,-19965044,Jason Statham,8,Steven Knight,34956
Columbia Pictures,78000000,Cody Cameron,41793567,Bill Hader,9,Erica Rivinoja,119793567
Prettybird,250000,Paul Schrader,-200506,Lindsay Lohan,8,Bret Easton Ellis,49494
Studio Ghibli,30000000,Hayao Miyazaki,-24790420,Hideaki Anno,2,Hayao Miyazaki,5209580
DreamWorks,28000000,Bill Condon,-24745828,Benedict Cumberbatch,10,Daniel Domscheit-Berg,3254172
Emmett/Furla/Oasis Films (EFO Films),35000000,Allen Hughes,-15298836,Mark Wahlberg,1,Brian Tucker,19701164
Worldview Entertainment,16000000,James Gray,-13986544,Marion Cotillard,5,James Gray,2013456
Forest Whitaker's Significant Productions,900000,Ryan Coogler,15197842,Michael B. Jordan,7,Ryan Coogler,16097842
Archer Street Productions,18000000,Jonathan Teplitzky,-13564917,Colin Firth,5,Frank Cottrell Boyce,4435083
Relativity Media,35000000,Robert Luketic,-27623973,Liam Hemsworth,8,Jason Hall,7376027
Callahan Filmworks,40000000,Peter Segal,-10192740,Robert De Niro,12,Tim Kelleher,29807260
Ecosse Films,15000000,Oliver Hirschbiegel,-14668366,Naomi Watts,12,Stephen Jeffreys,331634
DreamWorks Animation,135000000,David Soren,-51971872,Ryan Reynolds,7,Darren Lemke,83028128
Open Road Films,2500000,Michael Tiddes,37541683,Marlon Wayans,1,Marlon Wayans,40041683
Worldview Entertainment,4000000,Ti West,-3990961,Joe Swanberg,5,Ti West,9039
Prana Studios,50000000,Klay Hall,40288712,Carlos Alazraqui,8,John Lasseter,90288712
Dickhouse Productions,15000000,Jeff Tremaine,87003019,Johnny Knoxville,10,Johnny Knoxville,102003019
Worldview Entertainment,4000000,David Gordon Green,-3626625,Nicolas Cage,4,Gary Hawkins,373375
Day Twenty- Eight Films,3300000,Ron Krauss,-1940437,Vanessa Hudgens,10,Ron Krauss,1359563
Safran Company The,7000000,Jorge Dorado,-6995712,Mark Strong,1,Guy Holmes,4288
China Film Group,25000000,Keanu Reeves,-24899856,Tiger Hu Chen,7,Michael G. Cooney,100144
Scott Free Productions,6500000,Zal Batmanglij,-4231704,Brit Marling,6,Zal Batmanglij,2268296
Les Productions du Trésor,25500000,Guillaume Canet,-25458771,Clive Owen,11,Guillaume Canet,41229
Worldview Entertainment,8500000,Eran Creevy,-8493213,James McAvoy,3,Eran Creevy,6787
Unclaimed Freight Productions,5000000,Randall Miller,-4959960,Alan Rickman,10,Jody Savin,40040
American Film Company The,10000000,Peter Landesman,-9347645,Zac Efron,10,Peter Landesman,652355
Alebrije Cine y Video,5000000,Eugenio Derbez,39467206,Eugenio Derbez,9,Guillermo Ríos,44467206
Sikhya Entertainment,1000000,Ritesh Batra,3231500,Irrfan Khan,9,Ritesh Batra,4231500
Videovision Entertainment,35000000,Justin Chadwick,-26676915,Idris Elba,12,William Nicholson,8323085
Block 2 Pictures,38600000,Kar-Wai Wong,-32005041,Tony Chiu-Wai Leung,8,Kar-Wai Wong,6594959
Universal Pictures,17000000,Malcolm D. Lee,53525195,Monica Calhoun,11,Malcolm D. Lee,70525195
Art Pictures Studio,30000000,Fedor Bondarchuk,-28986055,Mariya Smolnikova,10,Sergey Snezhkin,1013945
Abbolita Productions,12000000,Daniel Schechter,-11738305,Jennifer Aniston,8,Daniel Schechter,261695
Memento Films Production,11000000,Asghar Farhadi,-9669404,Bérénice Bejo,8,Asghar Farhadi,1330596
Twentieth Century Fox Film Corporation,81000000,Matthew Vaughn,47261724,Colin Firth,2,Jane Goldman,128261724
Paramount Pictures,165000000,Christopher Nolan,23020017,Matthew McConaughey,11,Jonathan Nolan,188020017
Marvel Studios,170000000,James Gunn,163176600,Chris Pratt,8,James Gunn,333176600
Universal Pictures International (UPI),15000000,Alex Garland,10442958,Alicia Vikander,4,Alex Garland,25442958
Twentieth Century Fox Film Corporation,61000000,David Fincher,106767189,Ben Affleck,10,Gillian Flynn,167767189
Thunder Road Pictures,20000000,Chad Stahelski,23037835,Keanu Reeves,10,Derek Kolstad,43037835
Fox Searchlight Pictures,25000000,Wes Anderson,34100318,Ralph Fiennes,3,Stefan Zweig,59100318
Bold Films,3300000,Damien Chazelle,9792000,Miles Teller,1,Damien Chazelle,13092000
Twentieth Century Fox Film Corporation,34000000,Wes Ball,68427862,Dylan O'Brien,9,Noah Oppenheim,102427862
New Line Cinema,6500000,John R. Leonetti,77773813,Ward Horton,10,Gary Dauberman,84273813
Northern Lights Films,2000000,David Robert Mitchell,12673301,Maika Monroe,3,David Robert Mitchell,14673301
Summit Entertainment,85000000,Neil Burger,65947895,Shailene Woodley,3,Evan Daugherty,150947895
Black Bear Pictures,14000000,Morten Tyldum,77125683,Benedict Cumberbatch,12,Graham Moore,91125683
Chernin Entertainment,170000000,Matt Reeves,38545589,Gary Oldman,7,Mark Bomback,208545589
Warner Bros.,178000000,Doug Liman,-77793744,Tom Cruise,6,Christopher McQuarrie,100206256
Columbia Pictures,55000000,Antoine Fuqua,46530738,Denzel Washington,9,Richard Wenk,101530738
Paramount Pictures,210000000,Michael Bay,35439076,Mark Wahlberg,6,Ehren Kruger,245439076
Columbia Pictures,50000000,Phil Lord,141719337,Channing Tatum,6,Michael Bacall,191719337
Columbia Pictures,68000000,David Ayer,17817906,Brad Pitt,10,David Ayer,85817906
Fox 2000 Pictures,12000000,Josh Boone,112872350,Shailene Woodley,6,Scott Neustadter,124872350
New Regency Pictures,18000000,Alejandro González Iñárritu,24340598,Michael Keaton,11,Alejandro González Iñárritu,42340598
Bold Films,8500000,Dan Gilroy,23881218,Jake Gyllenhaal,10,Dan Gilroy,32381218
Twentieth Century Fox Film Corporation,200000000,Bryan Singer,33921534,Patrick Stewart,5,Simon Kinberg,233921534
Screen Australia,2000000,Jennifer Kent,-1075721,Essie Davis,11,Jennifer Kent,924279
Warner Bros.,58800000,Clint Eastwood,291326372,Bradley Cooper,1,Jason Hall,350126372
Marvel Entertainment,170000000,Anthony Russo,89766572,Chris Evans,4,Christopher Markus,259766572
Warner Bros.,60000000,Phil Lord,197760692,Chris Pratt,2,Phil Lord,257760692
Cross Creek Pictures,1500000,Jon Watts,-1444993,Andy Powers,6,Christopher Ford,55007
EuropaCorp,40000000,Luc Besson,86663600,Scarlett Johansson,7,Luc Besson,126663600
Marvel Enterprises,200000000,Marc Webb,2853933,Andrew Garfield,5,Alex Kurtzman,202853933
FortyFour Studios,165000000,Don Hall,57527828,Ryan Potter,11,Jordan Roberts,222527828
Roth Films,180000000,Robert Stromberg,61410378,Angelina Jolie,5,Linda Woolverton,241410378
Paramount Pictures,125000000,Darren Aronofsky,-23799956,Russell Crowe,3,Darren Aronofsky,101200044
Working Title Films,15000000,James Marsh,20893537,Eddie Redmayne,11,Anthony McCarten,35893537
New Line Cinema,250000000,Peter Jackson,5119788,Ian McKellen,12,Fran Walsh,255119788
Paramount Pictures,100000000,Brett Ratner,-27311386,Dwayne Johnson,7,Ryan Condal,72688614
TriStar Pictures,80000000,Paul W.S. Anderson,-56780252,Kit Harington,2,Janet Scott Batchler,23219748
Color Force,125000000,Francis Lawrence,212135885,Jennifer Lawrence,11,Peter Craig,337135885
Columbia Pictures,44000000,Evan Goldberg,-37894825,James Franco,12,Dan Sterling,6105175
Lionsgate,90000000,Patrick Hughes,-50677456,Sylvester Stallone,8,Sylvester Stallone,39322544
Corner Producciones,3300000,Damián Szifron,-192928,Darío Grandinetti,12,Damián Szifron,3107072
Asis Productions,25000000,Phillip Noyce,20089048,Brenton Thwaites,8,Michael Mitnick,45089048
Unison Films,1600000,Jemaine Clement,1733000,Jemaine Clement,2,Jemaine Clement,3333000
Warner Bros.,110000000,Noam Murro,-3419949,Sullivan Stapleton,3,Zack Snyder,106580051
Broad Green Pictures,8000000,Ramin Bahrani,-6589085,Andrew Garfield,10,Ramin Bahrani,1410915
Twentieth Century Fox Film Corporation,40000000,Nick Cassavetes,43911193,Cameron Diaz,4,Melissa Stack,83911193
Warner Bros.,160000000,Gareth Edwards,40676069,Aaron Taylor-Johnson,5,Max Borenstein,200676069
Lucamar Productions,50000000,Rob Marshall,78002372,Anna Kendrick,12,James Lapine,128002372
Aldamisa Entertainment,11000000,Jon Favreau,19640336,Jon Favreau,5,Jon Favreau,30640336
Chernin Entertainment,140000000,Ridley Scott,-74985487,Christian Bale,12,Adam Cooper,65014513
Bluegrass Films,40000000,Seth MacFarlane,3139300,Seth MacFarlane,5,Seth MacFarlane,43139300
Aldamisa Entertainment,65000000,Frank Miller,-51242196,Mickey Rourke,8,Frank Miller,13757804
Universal Pictures,70000000,Gary Shore,-13719645,Luke Evans,10,Matt Sazama,56280355
3 Arts Entertainment,65000000,Angelina Jolie,50637895,Jack O'Connell,12,Joel Coen,115637895
Beijing Skywheel Entertainment Co.,95000000,Sergei Bodrov,-77776735,Ben Barnes,2,Charles Leavitt,17223265
Bazelevs Production,1000000,Levan Gabriadze,30537320,Heather Sossaman,4,Nelson Greaves,31537320
EuropaCorp,48000000,Olivier Megaton,41256424,Liam Neeson,1,Luc Besson,89256424
Gulfstream Pictures,40000000,Frank Coraci,6294610,Adam Sandler,5,Ivan Menchell,46294610
DiNovi Pictures,26000000,Michael Hoffman,761283,James Marsden,10,J. Mills Goodloe,26761283
IFC Productions,4000000,Richard Linklater,21379975,Ellar Coltrane,8,Richard Linklater,25379975
Marcy Media,65000000,Will Gluck,20911262,Quvenzhané Wallis,12,Will Gluck,85911262
Columbia Pictures,40000000,Jake Kasdan,-1456527,Jason Segel,7,Kate Angelo,38543473
Ghoulardi Film Company,20000000,Paul Thomas Anderson,-11889025,Joaquin Phoenix,1,Paul Thomas Anderson,8110975
Fewlas Entertainment,1000000,Leigh Janiak,-990832,Rose Leslie,9,Phil Graziadei,9168
Paramount Pictures,60000000,Kenneth Branagh,-9422588,Chris Pine,1,Adam Cozad,50577412
Bob Industries,15000000,Jean-Marc Vallée,22880356,Reese Witherspoon,12,Nick Hornby,37880356
SModcast Pictures,3000000,Kevin Smith,-1178017,Justin Long,9,Kevin Smith,1821983
DreamWorks,66000000,Scott Waugh,-22422364,Aaron Paul,3,George Gatins,43577636
Reel FX Creative Studios,50000000,Jorge R. Gutiérrez,151543,Diego Luna,10,Jorge R. Gutiérrez,50151543
Good Universe,18000000,Nicholas Stoller,132157400,Seth Rogen,5,Andrew Jay Cohen,150157400
Metro-Goldwyn-Mayer (MGM),100000000,José Padilha,-41392993,Joel Kinnaman,2,Joshua Zetumer,58607007
Twentieth Century Fox Film Corporation,127000000,Shawn Levy,-13253379,Ben Stiller,12,David Guion,113746621
Big Screen Productions,12600000,Michaël R. Roskam,-1875611,Tom Hardy,9,Dennis Lehane,10724389
DiNovi Pictures,11000000,R.J. Cutler,39474843,Chloë Grace Moretz,8,Shauna Cross,50474843
DreamWorks Animation,145000000,Dean DeBlois,32002924,Jay Baruchel,6,Dean DeBlois,177002924
HanWay Films,5000000,Adam Wingard,-4677400,Dan Stevens,9,Simon Barrett,322600
Paramount Pictures,125000000,Jonathan Liebesman,66204754,Megan Fox,8,Josh Appelbaum,191204754
Summit Entertainment,70000000,Renny Harlin,-51151462,Kellan Lutz,1,Sean Hood,18848538
Angry Films,30000000,Mark Waters,-22208854,Zoey Deutch,2,Richelle Mead,7791146
Alcon Entertainment,100000000,Wally Pfister,-76977691,Johnny Depp,4,Jack Paglen,23022309
Annapurna Pictures,24000000,Bennett Miller,-11903700,Steve Carell,1,E. Max Frye,12096300
Chernin Entertainment,13000000,Theodore Melfi,31134898,Bill Murray,10,Theodore Melfi,44134898
Open Road Films,14000000,Erik Van Looy,-8018251,Karl Urban,1,Bart De Pauw,5981749
Paramount Pictures,25000000,Rupert Wyatt,8631221,Mark Wahlberg,12,William Monahan,33631221
Treehouse Pictures,8000000,Tom Gormican,18049082,Zac Efron,1,Tom Gormican,26049082
The Weinstein Company,10000000,Tim Burton,4479776,Amy Adams,12,Scott Alexander,14479776
Universal Pictures,9000000,James DeMonaco,62962800,Frank Grillo,7,James DeMonaco,71962800
StudioCanal,50000000,Jaume Collet-Serra,42168600,Liam Neeson,2,John W. Richardson,92168600
Broken Road Productions,50000000,Steven Quale,-2397806,Richard Armitage,8,John Swetnam,47602194
Warner Bros.,50000000,David Dobkin,-2880612,Robert Downey Jr.,10,Nick Schenk,47119388
Universal Pictures,35000000,Bobby Farrelly,51208010,Jim Carrey,11,Sean Anders,86208010
Legendary Entertainment,5000000,John Erick Dowdle,16197315,Perdita Weeks,8,John Erick Dowdle,21197315
Genre Films,17000000,Luke Greenfield,65390774,Jake Johnson,8,Luke Greenfield,82390774
BenderSpink,42000000,Sean Anders,12445357,Jason Bateman,11,Sean Anders,54445357
Before The Door Pictures,20000000,J.C. Chandor,-14259690,Oscar Isaac,1,J.C. Chandor,5740310
21 Laps Entertainment,19800000,Shawn Levy,14490142,Jason Bateman,9,Jonathan Tropper,34290142
Screen Gems,30000000,Scott Derrickson,577122,Eric Bana,7,Scott Derrickson,30577122
Village Roadshow Pictures,60000000,Akiva Goldsman,-59977549,Colin Farrell,2,Akiva Goldsman,22451
Scott Free Productions,22000000,Rowan Joffe,-19036988,Nicole Kidman,10,Rowan Joffe,2963012
Bluegrass Films,20000000,Shana Feste,3393765,Gabriella Wilde,2,Shana Feste,23393765
Gravier Productions,16800000,Woody Allen,-6293061,Colin Firth,8,Woody Allen,10506939
2929 Productions,30000000,Susanne Bier,-29823695,Bradley Cooper,2,Christopher Kyle,176305
EuropaCorp,28000000,McG,2697999,Kevin Costner,2,Adi Hasak,30697999
Amblin Entertainment,22000000,Lasse Hallström,32240821,Helen Mirren,8,Steven Knight,54240821
1984 Private Defense Contractors,28000000,Scott Frank,-1692400,Liam Neeson,9,Lawrence Block,26307600
Lutzus-Brown,5000000,Richard Glatzer,13754371,Julianne Moore,2,Richard Glatzer,18754371
Columbia Pictures,70000000,George Clooney,8031620,George Clooney,2,George Clooney,78031620
Automatik Entertainment,4000000,William Eubank,-3399104,Brenton Thwaites,7,Carlyle Eubank,600896
StudioCanal,55000000,Paul King,21223578,Hugh Bonneville,1,Paul King,76223578
Cinelou Films,7000000,Daniel Barnz,-5126453,Jennifer Aniston,1,Patrick Tobin,1873547
Pt. Merantau Films,4500000,Gareth Evans,-1874197,Iko Uwais,4,Gareth Evans,2625803
Universal Pictures,5000000,Stiles White,45856010,Olivia Cooke,10,Juliet Snowden,50856010
Hopscotch Features,65000000,Stuart Beattie,-45924710,Aaron Eckhart,1,Stuart Beattie,19075290
Pathé,20000000,Ava DuVernay,32076908,David Oyelowo,1,Paul Webb,52076908
EuropaCorp,16000000,Tommy Lee Jones,-13571117,Tommy Lee Jones,5,Tommy Lee Jones,2428883
Gail Katz Productions,19000000,Edward Zwick,-16563938,Tobey Maguire,9,Steven Knight,2436062
Stoney Lake Entertainment,16000000,Vic Armstrong,-2001718,Nicolas Cage,10,Jerry B. Jenkins,13998282
Lionsgate,15000000,Anton Corbijn,2237244,Philip Seymour Hoffman,8,Andrew Bovell,17237244
River Road Entertainment,10000000,Bill Pohlad,2547189,John Cusack,6,Oren Moverman,12547189
DreamWorks Animation,132000000,Eric Darnell,-48651080,Tom McGrath,11,Michael Colton,83348920
Open Road Films (II),35000000,David Ayer,-24491482,Arnold Schwarzenegger,3,Skip Woods,10508518
Prospero Pictures,15000000,David Cronenberg,-14652352,Julianne Moore,2,Bruce Wagner,347648
Sierra / Affinity,5000000,Michael Cuesta,-2549154,Jeremy Renner,4,Peter Landesman,2450846
Summit Entertainment,25000000,Ivan Reitman,3831145,Kevin Costner,4,Scott Rothman,28831145
Duplass Brothers Productions,100000,Charlie McDowell,411635,Mark Duplass,8,Justin Lader,511635
Paramount Pictures,16000000,Jason Reitman,-15538838,Kaitlyn Dever,10,Jason Reitman,461162
Scott Rudin Productions,10000000,Noah Baumbach,-2425934,Ben Stiller,4,Noah Baumbach,7574066
Pure Flix Productions,2000000,Harold Cronk,58755732,Shane Harper,3,Hunter Dennis,60755732
Offspring Entertainment,45000000,Trish Sie,-30095616,Ryan Guzman,8,Duane Adler,14904384
Bullwinkle Studios,145000000,Rob Minkoff,-33493570,Ty Burrell,3,Jay Ward,111506430
EuropaCorp,28000000,Camille Delamarre,-7714482,Paul Walker,4,Luc Besson,20285518
Warner Bros. Digital Distribution,6000000,Rob Thomas,-2680891,Kristen Bell,3,Rob Thomas,3319109
Walt Disney Pictures,28000000,Miguel Arteta,38954149,Steve Carell,10,Rob Lieber,66954149
Fear of God Films,22500000,Russell Crowe,-18309470,Russell Crowe,5,Andrew Knight,4190530
Relativity Media,15000000,Roger Donaldson,9984868,Pierce Brosnan,8,Michael Finch,24984868
Bold Films,2000000,Ryan Gosling,-1956718,Christina Hendricks,4,Ryan Gosling,43282
Gulfstream Pictures,42000000,Peter Lepeniotis,22251541,Will Arnett,1,Lorne Cameron,64251541
Chapter 2,17000000,Andrea Di Stefano,-16893131,Benicio Del Toro,6,Andrea Di Stefano,106869
Codeblack Entertainment,5000000,Bille Woodruff,12382982,Sharon Leal,10,Christina Welsh,17382982
Twentieth Century Fox Animation,103000000,Carlos Saldanha,28538435,Jesse Eisenberg,4,Don Rhymer,131538435
Four Seasons Partnership,40000000,Clint Eastwood,7034272,John Lloyd Young,6,Marshall Brickman,47034272
Worldview Entertainment,6000000,Zach Braff,-2411568,Zach Braff,7,Adam J. Braff,3588432
Gary Sanchez Productions,20000000,Ben Falcone,64525432,Melissa McCarthy,7,Melissa McCarthy,84525432
Camfam Studios,500000,Darren Doane,2283970,Kirk Cameron,11,Darren Doane,2783970
Cube Vision,25000000,Tim Story,109938200,Ice Cube,1,Greg Coolidge,134938200
Anonymous Content,5000000,Lynn Shelton,-4559662,Keira Knightley,10,Andrea Seigel,440338
Laika Entertainment,60000000,Graham Annable,-9162695,Ben Kingsley,9,Irena Brignull,50837305
Abbolita Productions,2400000,Jeff Baena,-2319685,Aubrey Plaza,7,Jeff Baena,80315
Black Entertainment Television (BET),7000000,Gina Prince-Bythewood,7618727,Gugu Mbatha-Raw,11,Gina Prince-Bythewood,14618727
IAC Films,12000000,Chris Rock,13277561,Chris Rock,12,Chris Rock,25277561
Alcon Entertainment,20000000,Philippe Falardeau,-17283011,Reese Witherspoon,10,Margaret Nagle,2716989
Walt Disney Pictures,25000000,Craig Gillespie,11447959,Jon Hamm,5,Tom McCarthy,36447959
GNK Productions,1000000,Peter Sattler,-990163,Kristen Stewart,10,Peter Sattler,9837
ASIG Productions,18000000,Rob Reiner,-2844228,Michael Douglas,7,Mark Andrus,15155772
Porchlight Films,8500000,David Michôd,-7390801,Guy Pearce,6,Joel Edgerton,1109199
Affirm Films,5000000,Andrew Erwin,5429707,Sarah Drew,5,Jon Erwin,10429707
LStar Capital,24000000,Tim Story,41182182,Kevin Hart,6,Keith Merryman,65182182
Screen Gems,12500000,Steve Pink,36137684,Kevin Hart,2,Leslye Headland,48637684
Rook Films,1000000,Peter Strickland,-967370,Sidse Babett Knudsen,1,Peter Strickland,32630
Gordon Bijelonic / Datari Turner Films,5000000,John Stockwell,-4994435,Jonathan Daniel Brown,4,John Stockwell,5565
Alliance Films,15000000,Tom Harper,11496583,Helen McCrory,1,Jon Croker,26496583
Unified Pictures,5000000,William H. Macy,-4962560,Billy Crudup,2,Casey Twenter,37440
Walt Disney Pictures,50000000,James Bobin,1183113,Ricky Gervais,3,James Bobin,51183113
Relativity Media,13000000,Dave Green,25916903,Teo Halm,7,Henry Gayden,38916903
Screen Gems,13200000,Sam Miller,39343632,Taraji P. Henson,9,Aimee Lagos,52543632
Affirm Films,15000000,Thomas Carter,15127963,Jim Caviezel,8,Scott Marshall Smith,30127963
RADiUS-TWC,4000000,Daniel Stamm,-3990866,Mark Webber,4,David Birke,9134
TriStar Pictures,12000000,Randall Wallace,79443253,Greg Kinnear,4,Randall Wallace,91443253
Occupant Entertainment,5000000,Geoff Moore,-4927727,Sam Rockwell,3,Geoff Moore,72273
Baby Way Productions,4000000,Michael Tiddes,13329486,Marlon Wayans,4,Marlon Wayans,17329486
WhiteFlame Productions,6000000,Andrew Fleming,-5988234,Evan Rachel Wood,9,Stephen Zotnowski,11766
Unison Films,3000000,Ned Benson,-2414360,James McAvoy,9,Ned Benson,585640
Exclusive Media Group,200000,John Pogue,8296112,Jared Harris,4,Craig Rosenberg,8496112
Park Pictures,1000000,John Slattery,-895599,Philip Seymour Hoffman,8,Peter Dexter,104401
Lucasfilm,245000000,J.J. Abrams,691662225,Daisy Ridley,12,Lawrence Kasdan,936662225
Warner Bros. Pictures,150000000,George Miller,3636354,Tom Hardy,5,George Miller,153636354
Visiona Romantica,44000000,Quentin Tarantino,10117416,Samuel L. Jackson,12,Quentin Tarantino,54117416
Village Roadshow Pictures,110000000,Brad Peyton,45190832,Dwayne Johnson,5,Carlton Cuse,155190832
Black Label Media,30000000,Denis Villeneuve,16889293,Emily Blunt,10,Taylor Sheridan,46889293
Focus Features,40000000,Sam Taylor-Johnson,126167230,Dakota Johnson,2,Kelly Marcel,166167230
Paramount Pictures,155000000,Alan Taylor,-65239044,Arnold Schwarzenegger,7,Laeta Kalogridis,89760956
Regency Enterprises,135000000,Alejandro González Iñárritu,48637894,Leonardo DiCaprio,1,Mark L. Smith,183637894
Twentieth Century Fox Film Corporation,108000000,Ridley Scott,120433663,Matt Damon,10,Drew Goddard,228433663
Gotham Group,61000000,Wes Ball,20670090,Dylan O'Brien,9,T.S. Nowlin,81670090
B24,245000000,Sam Mendes,-44925825,Daniel Craig,11,John Logan,200074175
Universal Pictures,150000000,Colin Trevorrow,502270625,Chris Pratt,6,Rick Jaffa,652270625
Parts and Labor,3500000,Robert Eggers,21638292,Anya Taylor-Joy,2,Robert Eggers,25138292
Element Pictures,13000000,Lenny Abrahamson,1677654,Brie Larson,1,Emma Donoghue,14677654
Allison Shearmur Productions,95000000,Kenneth Branagh,106151353,Lily James,3,Chris Weitz,201151353
Plan B Entertainment,28000000,Adam McKay,42259870,Christian Bale,12,Charles Randolph,70259870
Cross Creek Pictures,30000000,Brian Helgeland,-28127006,Tom Hardy,11,Brian Helgeland,1872994
Twentieth Century Fox Film Corporation,65000000,Paul Feig,45825712,Melissa McCarthy,6,Paul Feig,110825712
Marvel Studios,250000000,Joss Whedon,209005868,Robert Downey Jr.,5,Joss Whedon,459005868
Walt Disney Pictures,190000000,Brad Bird,-96563678,George Clooney,5,Damon Lindelof,93436322
Warner Bros.,75000000,Guy Ritchie,-29554891,Henry Cavill,8,Guy Ritchie,45445109
Working Title Films,15000000,Tom Hooper,-2293607,Eddie Redmayne,1,David Ebershoff,12706393
Pixar Animation Studios,175000000,Pete Docter,181461711,Amy Poehler,6,Pete Docter,356461711
Warner Bros.,176000000,Lana Wachowski,-128612277,Channing Tatum,2,Lilly Wachowski,47387723
Black Bear Pictures,2500000,Eli Roth,-2463664,Keanu Reeves,10,Eli Roth,36336
Participant Media,20000000,Tom McCarthy,25055776,Mark Ruffalo,11,Josh Singer,45055776
The Weinstein Company,11800000,Todd Haynes,911491,Cate Blanchett,1,Phyllis Nagy,12711491
Paramount Pictures,150000000,Christopher McQuarrie,45042377,Tom Cruise,7,Christopher McQuarrie,195042377
Universal Pictures,190000000,James Wan,163007020,Vin Diesel,4,Chris Morgan,353007020
Brownstone Productions (II),29000000,Elizabeth Banks,155296230,Anna Kendrick,5,Kay Cannon,184296230
3 Arts Entertainment,20000000,John Wells,-6349262,Bradley Cooper,10,Steven Knight,13650738
Working Title Films,55000000,Baltasar Kormákur,-11517730,Jason Clarke,9,William Nicholson,43482270
Gary Sanchez Productions,130000000,Peyton Reed,50202163,Paul Rudd,7,Edgar Wright,180202163
Universal Pictures,28000000,F. Gary Gray,133197785,O'Shea Jackson Jr.,8,Jonathan Herman,161197785
Color Force,160000000,Francis Lawrence,121723902,Jennifer Lawrence,11,Peter Craig,281723902
Blinding Edge Pictures,5000000,M. Night Shyamalan,60206105,Olivia DeJonge,9,M. Night Shyamalan,65206105
Lakeshore Entertainment,25000000,Lee Toland Krieger,17478175,Blake Lively,4,J. Mills Goodloe,42478175
Cross Creek Pictures,53000000,Scott Cooper,9575678,Johnny Depp,9,Mark Mallouk,62575678
Double Dare You (DDY),55000000,Guillermo del Toro,-23943055,Mia Wasikowska,10,Guillermo del Toro,31056945
Escape Artists,30000000,Antoine Fuqua,22421953,Jake Gyllenhaal,7,Kurt Sutter,52421953
Metro-Goldwyn-Mayer (MGM),35000000,Ryan Coogler,74767581,Michael B. Jordan,11,Ryan Coogler,109767581
Summit Entertainment,110000000,Robert Schwentke,20179072,Shailene Woodley,3,Brian Duffield,130179072
Twentieth Century Fox Film Corporation,35000000,Aleksander Bach,-12535570,Rupert Friend,8,Skip Woods,22464430
CBS Films,8500000,Ari Sandel,25517854,Mae Whitman,2,Josh A. Cagan,34017854
Universal Pictures,35000000,Judd Apatow,75212700,Amy Schumer,7,Amy Schumer,110212700
Blumhouse Productions,5000000,Joel Edgerton,38771291,Jason Bateman,8,Joel Edgerton,43771291
Alcon Entertainment,105000000,Ericson Core,-76217519,Edgar Ramírez,12,Kurt Wimmer,28782481
Columbia Pictures,80000000,Genndy Tartakovsky,89700110,Adam Sandler,9,Robert Smigel,169700110
Paramount Pictures,50000000,Sean Anders,100357137,Will Ferrell,12,Brian Burns,150357137
DreamWorks,40000000,Steven Spielberg,32313754,Tom Hanks,10,Matt Charman,72313754
Universal Pictures,30000000,Danny Boyle,-12249417,Michael Fassbender,10,Aaron Sorkin,17750583
BenderSpink,31000000,John Francis Daley,27884188,Ed Helms,7,Jonathan Goldstein,58884188
Summit Entertainment,90000000,Breck Eisner,-62632340,Vin Diesel,10,Cory Goodman,27367660
Twentieth Century Fox Film Corporation,120000000,Josh Trank,-63882452,Miles Teller,8,Jeremy Slater,56117548
Kramer & Sigman Films,50100000,Glenn Ficarra,3762963,Will Smith,2,Glenn Ficarra,53862963
Waverly Films,35000000,Nancy Meyers,40764672,Robert De Niro,9,Nancy Meyers,75764672
Columbia Pictures,49000000,Neill Blomkamp,-17430732,Sharlto Copley,3,Neill Blomkamp,31569268
Wildgaze Films,11000000,John Crowley,27317535,Saoirse Ronan,11,Nick Hornby,38317535
Illumination Entertainment,74000000,Kyle Balda,262045770,Sandra Bullock,7,Brian Lynch,336045770
Columbia Pictures,37000000,Cameron Crowe,-16008503,Bradley Cooper,5,Cameron Crowe,20991497
Black Label Media,10000000,Jean-Marc Vallée,-8021408,Jake Gyllenhaal,4,Bryan Sipe,1978592
Warner Bros.,14800000,Gregory Jacobs,51213057,Channing Tatum,7,Reid Carolin,66013057
Broad Green Pictures,5000000,Jeremy Saulnier,-1780971,Anton Yelchin,5,Jeremy Saulnier,3219029
Fox 2000 Pictures,34000000,George Tillman Jr.,3432299,Scott Eastwood,4,Nicholas Sparks,37432299
Warner Bros.,100000000,Ron Howard,-74979242,Chris Hemsworth,12,Charles Leavitt,25020758
Fox 2000 Pictures,60000000,David O. Russell,-3548768,Jennifer Lawrence,12,David O. Russell,56451232
Columbia Pictures,88000000,Chris Columbus,-9252415,Adam Sandler,7,Tim Herlihy,78747585
Fox 2000 Pictures,12000000,Jake Schreier,20000304,Nat Wolff,7,Scott Neustadter,32000304
Cantillon Company The,35000000,Peter Landesman,-468168,Will Smith,12,Peter Landesman,34531832
Gary Sanchez Productions,40000000,Etan Cohen,50411453,Will Ferrell,3,Jay Martel,90411453
Universal Pictures,68000000,Seth MacFarlane,13476385,Mark Wahlberg,6,Seth MacFarlane,81476385
Caviar,2000000,Marielle Heller,-522998,Bel Powley,8,Phoebe Gloeckner,1477002
Columbia Pictures,58000000,Rob Letterman,22080379,Jack Black,10,Darren Lemke,80080379
Bazelevs Production,2000000,Ilya Naishuller,7244565,Sharlto Copley,4,Ilya Naishuller,9244565
Broken Road Productions,15000000,Christopher Landon,-11364708,Tye Sheridan,10,Carrie Lee Wilson,3635292
Worldview Entertainment,50000000,Daniel Espinosa,-48793865,Tom Hardy,4,Richard Price,1206135
Warner Bros.,150000000,Joe Wright,-114911680,Levi Miller,10,Jason Fuchs,35088320
See-Saw Films,15000000,Justin Kurzel,-13891753,Michael Fassbender,12,Todd Louiso,1108247
Gramercy Pictures (I),10000000,Leigh Whannell,42218558,Dermot Mulroney,6,Leigh Whannell,52218558
Bold Films,16200000,John Erick Dowdle,11085953,Lake Bell,8,John Erick Dowdle,27285953
Endgame Entertainment,26000000,Tarsem Singh,-13723190,Ryan Reynolds,7,Àlex Pastor,12276810
Amasia Entertainment,8000000,Paco Cabezas,-7974631,Anna Kendrick,4,Max Landis,25369
IM Global,19500000,Billy Ray,680155,Chiwetel Ejiofor,11,Billy Ray,20180155
Columbia Pictures,25000000,Jonathan Levine,18035725,Joseph Gordon-Levitt,11,Jonathan Levine,43035725
Pixar Animation Studios,200000000,Peter Sohn,-76912880,Jeffrey Wright,11,Bob Peterson,123087120
DreamWorks Animation,135000000,Tim Johnson,42397510,Jim Parsons,3,Tom J. Astle,177397510
Sony Pictures Entertainment (SPE),35000000,Robert Zemeckis,-24862498,Joseph Gordon-Levitt,10,Robert Zemeckis,10137502
Davis Entertainment,40000000,Paul McGuigan,-34224924,Daniel Radcliffe,11,Max Landis,5775076
Legendary Entertainment,15000000,Michael Dougherty,27592530,Adam Scott,12,Todd Casey,42592530
Indian Paintbrush,8000000,Alfonso Gomez-Rejon,-1256224,Thomas Mann,7,Jesse Andrews,6743776
1821 Pictures,25000000,Gavin O'Connor,-23487185,Natalie Portman,1,Brian Duffield,1512815
EuropaCorp,25000000,Camille Delamarre,-8972134,Ed Skrein,9,Adam Cooper,16027866
Warner Bros.,30000000,Doug Ellin,2361416,Adrian Grenier,6,Doug Ellin,32361416
Forest Whitaker's Significant Productions,7000000,Rick Famuyiwa,10474107,Shameik Moore,6,Rick Famuyiwa,17474107
Warner Bros.,50000000,Jaume Collet-Serra,-23557749,Liam Neeson,3,Brad Ingelsby,26442251
Universal Pictures,10000000,Angelina Jolie,-9468991,Brad Pitt,1,Angelina Jolie,531009
Raindog Films,13000000,Gavin Hood,5700837,Helen Mirren,4,Guy Hibbert,18700837
Freedom Media,16000000,Drake Doremus,-15967905,Nicholas Hoult,5,Nathan Parker,32095
LStar Capital,23000000,Jeremy Garelick,41460211,Kevin Hart,1,Jeremy Garelick,64460211
StudioCanal,2000000,Max Joseph,1590010,Zac Efron,8,Max Joseph,3590010
Princess Grace Foundation The,6000000,Cary Fukunaga,-5916139,Abraham Attah,10,Cary Fukunaga,83861
Little Stranger,30000000,Jason Moore,57044645,Amy Poehler,12,Paula Pell,87044645
PalmStar Media,28000000,Nima Nourizadeh,-13565396,Jesse Eisenberg,8,Max Landis,14434604
Origin Pictures,11000000,Simon Curtis,22305037,Helen Mirren,4,Alexi Kaye Campbell,33305037
Harmonius Claptrap,8000000,Duke Johnson,-4557180,David Thewlis,2,Charlie Kaufman,3442820
Insurge Pictures,12000000,Dean Israelite,10331028,Amy Landecker,1,Jason Pagan,22331028
Gravier Productions,11000000,Woody Allen,-6972236,Joaquin Phoenix,8,Woody Allen,4027764
StudioCanal,40000000,Pierre Morel,-29359355,Sean Penn,3,Jean-Patrick Manchette,10640645
Universal Pictures,4000000,Rob Cohen,31385560,Jennifer Lopez,1,Barbara Curry,35385560
OddLot Entertainment,60000000,David Koepp,-52394332,Johnny Depp,1,Eric Aronson,7605668
Bleecker Street Films,15000000,Jay Roach,-7142259,Bryan Cranston,11,John McNamara,7857741
Entertainment One,10000000,Ciarán Foy,17736779,James Ransone,8,Scott Derrickson,27736779
Onyx Films,81200000,Mark Osborne,-79860848,Jeff Bridges,8,Irena Brignull,1339152
Duplass Brothers Productions,3500000,Bryan Buckley,-2884346,Melissa Rauch,3,Melissa Rauch,615654
Fox 2000 Pictures,35000000,Gil Kenan,12425125,Sam Rockwell,5,David Lindsay-Abaire,47425125
Route One Entertainment,8000000,Ken Kwapis,21467855,Robert Redford,9,Michael Arndt,29467855
Alcon Entertainment,26000000,Patricia Riggen,-13811358,Antonio Banderas,11,Mikko Alanne,12188642
Paramount Animation,74000000,Paul Tibbitt,88994032,Tom Kenny,2,Glenn Berger,162994032
Bloom,25000000,Gus Van Sant,-24979917,Matthew McConaughey,8,Chris Sparling,20083
Duplass Brothers Productions,100000,Sean Baker,601837,Kitana Kiki Rodriguez,7,Sean Baker,701837
Forward Pass,70000000,Michael Mann,-62902875,Chris Hemsworth,1,Morgan Davis Foehl,7097125
Fox 2000 Pictures,90000000,Walt Becker,-4113013,Jason Lee,12,Ross Bagdasarian,85886987
Enderby Entertainment,8000000,Daniel Alfredson,-7983542,Anthony Hopkins,6,Castle Freeman Jr.,16458
Red Crown Productions,1000000,Michael Showalter,13443077,Sally Field,4,Laura Terruso,14443077
Metro-Goldwyn-Mayer (MGM),35000000,Anne Fletcher,-492921,Reese Witherspoon,5,David Feeney,34507079
Participant Media,28000000,David Gordon Green,-21001676,Sandra Bullock,10,Peter Straughan,6998324
Lionsgate,8500000,Henry Hobson,-8312888,Arnold Schwarzenegger,5,John Scott 3,187112
FaithStep Films,3000000,Alex Kendrick,64790117,Priscilla C. Shirer,8,Alex Kendrick,67790117
Sony Pictures Classics,9600000,James Vanderbilt,-7058446,Cate Blanchett,10,James Vanderbilt,2541554
Panorama Studios,9400000,Nishikant Kamat,-8660522,Ajay Devgn,7,Jeethu Joseph,739478
Clinica Estetico,18000000,Jonathan Demme,8822144,Meryl Streep,8,Diablo Cody,26822144
Allspark Pictures,5000000,Jon M. Chu,-2815360,Aubrey Peeples,10,Ryan Landels,2184640
Ruby Films,14000000,Sarah Gavron,-9306644,Carey Mulligan,12,Abi Morgan,4693356
Metro-Goldwyn-Mayer (MGM),20000000,Boaz Yakin,22652003,Thomas Haden Church,6,Boaz Yakin,42652003
Arka Mediaworks,18026148,S.S. Rajamouli,-11288148,Prabhas,7,Vijayendra Prasad,6738000
Blumhouse Productions,3300000,David Gelb,22499043,Olivia Wilde,2,Luke Dawson,25799043
Mayhem Pictures,17000000,Niki Caro,27469602,Kevin Costner,2,Christopher Cleveland,44469602
Sparkle Roll Media,65000000,Daniel Lee,-64925932,Jackie Chan,9,Daniel Lee,74068
Miramax,10000000,Bill Condon,7737646,Ian McKellen,7,Mitch Cullin,17737646
Esperanto Kino,3000000,Jonás Cuarón,-1171067,Gael García Bernal,4,Jonás Cuarón,1828933
CBS Films,17000000,Jessie Nelson,9284475,Steve Martin,11,Steven Rogers,26284475
Twentieth Century Fox Animation,99000000,Steve Martino,31178411,Noah Schnapp,11,Craig Schulz,130178411
Dreams Salon Entertainment Culture,36000000,Wilson Yip,-33320563,Donnie Yen,12,Tai-lee Chan,2679437
Big Indie Pictures,10000000,Dan Fogelman,-4651683,Al Pacino,4,Dan Fogelman,5348317
Rocklin \ Faust,12000000,David M. Rosenthal,45017904,Sanaa Lathan,9,Alan B. McElroy,57017904
Bron Studios,13000000,Marc Abraham,-11353532,Tom Hiddleston,4,Marc Abraham,1646468
Big Beach Films,5000000,Gaby Dellal,-4933629,Naomi Watts,9,Nikole Beckwith,66371
Worldview Entertainment,10000000,Kim Farrant,-9982528,Nicole Kidman,7,Michael Kinirons,17472
Columbia Pictures,30000000,Andy Fickman,41038190,Kevin James,4,Kevin James,71038190
BBC Films,6000000,Nicholas Hytner,4017675,Maggie Smith,2,Alan Bennett,10017675
Paramount Pictures,14000000,Steve Pink,-1717323,Rob Corddry,2,Josh Heald,12282677
Blumhouse Productions,10000000,Gregory Plotkin,8300124,Chris J. Murray,10,Jason Pagan,18300124
Babieka,10000000,John Madden,23078266,Judi Dench,3,Ol Parker,33078266
Regency Enterprises,35000000,Ken Scott,-24785987,Vince Vaughn,3,Steve Conrad,10214013
Double Feature Films,7000000,Peter Sollett,-6467012,Julianne Moore,3,Ron Nyswaner,532988
BN Films,2000000,Jerry Jameson,557668,Kate Mara,9,Brian Bird,2557668
Ealing Studios Entertainment,3000000,Andrew Mogel,-2339006,Jack Black,5,Jarrad Paul,660994
See-Saw Films,2000000,John Maclean,-1770906,Kodi Smit-McPhee,4,John Maclean,229094
Motlys,11000000,Joachim Trier,-10838211,Jesse Eisenberg,7,Joachim Trier,161789
Audax Films,800000,Jon Watts,-671998,Kevin Bacon,8,Jon Watts,128002
Buffalo Films,1400000,Ciro Guerra,-70751,Nilbio Torres,5,Ciro Guerra,1329249
Avi Chai fund,4000000,Natalie Portman,-3430619,Natalie Portman,8,Natalie Portman,569381
StudioCanal,25000000,Mark Burton,-5624018,Justin Fletcher,8,Mark Burton,19375982
Anonymous Content,3200000,Lorene Scafaria,1065673,Susan Sarandon,6,Lorene Scafaria,4265673
Covert Media,15000000,Barry Levinson,-12017719,Bill Murray,10,Mitch Glazer,2982281
Central Motion Pictures,15000000,Hsiao-Hsien Hou,-14386444,Qi Shu,9,Cheng Ah,613556
Metanoia Films,20000000,Alejandro Monteverde,-13579681,Jakob Salvati,4,Alejandro Monteverde,6420319
Lionsgate,8000000,Mark Neveldine,-6287889,Olivia Taylor Dudley,8,Christopher Borrelli,1712111
Astute Films,5000000,Michael Polish,-299639,Kate Bosworth,9,Michael Polish,4700361
Human Stew Factory,6000000,Ana Lily Amirpour,-5822320,Suki Waterhouse,6,Ana Lily Amirpour,177680
Regency Enterprises,125000000,Justin Kurzel,-70354277,Michael Fassbender,12,Michael Lesslie,54645723
Summit Entertainment,30000000,Damien Chazelle,121101803,Ryan Gosling,12,Damien Chazelle,151101803
Atlas Entertainment,175000000,David Ayer,150100054,Will Smith,8,David Ayer,325100054
Dentsu,75000000,Garth Jennings,195329045,Matthew McConaughey,12,Garth Jennings,270329045
Heyday Films,180000000,David Yates,54037575,Eddie Redmayne,11,J.K. Rowling,234037575
Walt Disney Animation Studios,150000000,Ron Clements,98757044,Auli'i Cravalho,11,Jared Bush,248757044
Metro-Goldwyn-Mayer (MGM),90000000,Antoine Fuqua,3381044,Denzel Washington,9,Akira Kurosawa,93381044
Warner Bros.,44000000,Gavin O'Connor,42198014,Ben Affleck,10,Bill Dubuque,86198014
Keep Your Head,30000000,James Gray,-21425661,Charlie Hunnam,4,James Gray,8574339
Focus Features,22500000,Tom Ford,-11860886,Amy Adams,12,Tom Ford,10639114
Levantine Films,25000000,Theodore Melfi,144380936,Taraji P. Henson,1,Allison Schroeder,169380936
Lava Bear Films,47000000,Denis Villeneuve,53546139,Amy Adams,11,Eric Heisserer,100546139
DreamWorks Animation,125000000,Mike Mitchell,28707064,Anna Kendrick,11,Jonathan Aibel,153707064
Lucasfilm,200000000,Gareth Edwards,332177324,Felicity Jones,12,Chris Weitz,532177324
Cross Creek Pictures,40000000,Mel Gibson,27115062,Andrew Garfield,11,Robert Schenkkan,67115062
Twentieth Century Fox Film Corporation,58000000,Tim Miller,305070709,Ryan Reynolds,2,Rhett Reese,363070709
Blinding Edge Pictures,9000000,M. Night Shyamalan,129141585,James McAvoy,1,M. Night Shyamalan,138141585
Columbia Pictures,110000000,Morten Tyldum,-9985301,Jennifer Lawrence,12,Jon Spaihts,100014699
Warner Bros.,250000000,Zack Snyder,80360194,Ben Affleck,3,Chris Terrio,330360194
Paramount Pictures,185000000,Justin Lin,-26151660,Chris Pine,7,Simon Pegg,158848340
Marvel Studios,165000000,Scott Derrickson,67641920,Benedict Cumberbatch,11,Jon Spaihts,232641920
The Weinstein Company,12000000,Garth Davis,39694854,Dev Patel,1,Saroo Brierley,51694854
Marvel Studios,250000000,Anthony Russo,158084349,Chris Evans,5,Christopher Markus,408084349
New Line Cinema,40000000,James Wan,62470008,Vera Farmiga,6,Carey Hayes,102470008
Metro-Goldwyn-Mayer (MGM),20000000,Thea Sharrock,36245075,Emilia Clarke,6,Jojo Moyes,56245075
Amblin Partners,45000000,Tate Taylor,30311445,Emily Blunt,10,Erin Cressida Wilson,75311445
Twentieth Century Fox Film Corporation,178000000,Bryan Singer,-22557511,James McAvoy,5,Simon Kinberg,155442489
Amazon Studios,8500000,Kenneth Lonergan,39195120,Casey Affleck,12,Kenneth Lonergan,47695120
Walt Disney Pictures,150000000,Byron Howard,191268248,Ginnifer Goodwin,3,Byron Howard,341268248
GK Films,85000000,Robert Zemeckis,-44930913,Brad Pitt,11,Steven Knight,40069087
Constantin Film,40000000,Paul W.S. Anderson,-13169932,Milla Jovovich,1,Paul W.S. Anderson,26830068
A24,1500000,Barry Jenkins,26350912,Mahershala Ali,11,Barry Jenkins,27850912
Screen Gems,9900000,Fede Alvarez,79310468,Stephen Lang,8,Fede Alvarez,89210468
Film 44,12000000,David Mackenzie,14862450,Chris Pine,8,Taylor Sheridan,26862450
Mandeville Films,110000000,Robert Schwentke,-43997807,Shailene Woodley,3,Noah Oppenheim,66002193
Twentieth Century Fox Film Corporation,110000000,Tim Burton,-22757166,Eva Green,9,Ransom Riggs,87242834
Cappa Defina Productions,46000000,Martin Scorsese,-38920809,Andrew Garfield,1,Jay Cocks,7079191
Captivate Entertainment,120000000,Paul Greengrass,42434410,Matt Damon,7,Paul Greengrass,162434410
Gracie Films,9000000,Kelly Fremon Craig,5260193,Hailee Steinfeld,11,Kelly Fremon Craig,14260193
FilmNation Entertainment,25000000,John Lee Hancock,-12214907,Michael Keaton,1,Robert D. Siegel,12785093
Warner Bros. Pictures,180000000,David Yates,-53356939,Alexander Skarsgård,7,Adam Cozad,126643061
Lakeshore Entertainment,35000000,Anna Foerster,-4651740,Kate Beckinsale,1,Cory Goodman,30348260
Black Bear Pictures,20000000,Stephen Gaghan,-12777036,Matthew McConaughey,1,Patrick Massett,7222964
Misty Mountains,50000000,Shane Black,-13738237,Russell Crowe,5,Shane Black,36261763
Apaches Entertainment,43000000,J.A. Bayona,-39269018,Lewis MacDougall,1,Patrick Ness,3730982
Flashlight Films,60000000,Clint Eastwood,65070033,Tom Hanks,9,Todd Komarnicki,125070033
STX Entertainment,20000000,Jon Lucas,93257297,Mila Kunis,7,Jon Lucas,113257297
Quad Productions,30000000,Eric Summer,-17239015,Elle Fanning,8,Eric Summer,12760985
Regency Enterprises,40000000,Gore Verbinski,-31893014,Dane DeHaan,2,Justin Haythe,8106986
Legendary East,150000000,Yimou Zhang,-104842895,Matt Damon,2,Carlo Bernard,45157105
BZ Entertainment,40000000,Todd Phillips,3017433,Jonah Hill,8,Stephen Chin,43017433
Twentieth Century Fox Film Corporation,38000000,John Hamburg,22269575,Zoey Deutch,12,John Hamburg,60269575
Fox Searchlight Pictures,9000000,Pablo Larraín,4958679,Natalie Portman,12,Noah Oppenheim,13958679
Appian Way,108000000,Ben Affleck,-97622442,Ben Affleck,1,Ben Affleck,10377558
Universal Pictures,75000000,Chris Renaud,293384330,Louis C.K.,7,Cinco Paul,368384330
Pyramania,140000000,Alex Proyas,-108846536,Brenton Thwaites,2,Matt Sazama,31153464
Fox 2000 Pictures,40000000,Greg Mottola,-25103202,Zach Galifianakis,10,Michael LeSieur,14896798
Paramount Pictures,60000000,Edward Zwick,-1600840,Tom Cruise,10,Richard Wenk,58399160
Annapurna Pictures,19000000,Greg Tiernan,78661826,Seth Rogen,8,Kyle Hunter,97661826
Paramount Pictures,50000000,Michael Bay,2853219,John Krasinski,1,Chuck Hogan,52853219
New Line Cinema,36000000,David Frankel,-5017045,Will Smith,12,Allan Loeb,30982955
Columbia Pictures,75000000,Ron Howard,-40656426,Tom Hanks,10,Dan Brown,34343574
Lifetime Films,5000000,Eleanor Coppola,300675,Diane Lane,8,Eleanor Coppola,5300675
Transfilm,13000000,John Madden,-9560829,Jessica Chastain,12,Jonathan Perera,3439171
Columbia Pictures,144000000,Paul Feig,-15655911,Melissa McCarthy,7,Katie Dippold,128344089
Paramount Pictures,15000000,Dan Trachtenberg,56897215,John Goodman,3,Josh Campbell,71897215
Allison Shearmur Productions,20000000,Henry Joost,18562379,Emma Roberts,7,Jeanne Ryan,38562379
Legendary Entertainment,160000000,Duncan Jones,-112634710,Travis Fimmel,6,Charles Leavitt,47365290
Twentieth Century Fox Film Corporation,33000000,Jake Szymanski,13007113,Zac Efron,7,Andrew Jay Cohen,46007113
K/O Paper Products,90000000,Jon M. Chu,-24924460,Jesse Eisenberg,6,Ed Solomon,65075540
Fairview Entertainment,175000000,Jon Favreau,189001123,Neel Sethi,4,Justin Marks,364001123
Space Rocket Nation,7000000,Nicolas Winding Refn,-5666876,Elle Fanning,6,Nicolas Winding Refn,1333124
Summit Entertainment,110000000,Peter Berg,-48715053,Mark Wahlberg,9,Matthew Michael Carnahan,61284947
Columbia Pictures,17000000,Jaume Collet-Serra,38121623,Blake Lively,6,Anthony Jaswinski,55121623
Bron Studios,24000000,Denzel Washington,33642961,Denzel Washington,12,August Wilson,57642961
Hurwitz Creative,23000000,Dexter Fletcher,-7214368,Taron Egerton,2,Sean Macaulay,15785632
BH Tilt,5000000,Greg McLean,5164675,John Gallagher Jr.,3,James Gunn,10164675
Bluegrass Films,45000000,Peter Berg,-13113639,Mark Wahlberg,1,Peter Berg,31886361
New Line Cinema,4900000,David F. Sandberg,62335683,Teresa Palmer,7,Eric Heisserer,67235683
Endgame Entertainment,40000000,Oliver Stone,-18412481,Joseph Gordon-Levitt,9,Kieran Fitzgerald,21587519
Pixar Animation Studios,200000000,Andrew Stanton,286295561,Ellen DeGeneres,6,Andrew Stanton,486295561
Universal Pictures,115000000,Cedric Nicolas-Troyan,-67047980,Chris Hemsworth,4,Evan Spiliotopoulos,47952020
Film4,10000000,Ben Wheatley,-8201528,Sharlto Copley,4,Amy Jump,1798472
Heyday Films,20000000,Derek Cianfrance,-7454021,Michael Fassbender,9,Derek Cianfrance,12545979
Twentieth Century Fox Film Corporation,165000000,Roland Emmerich,-61855714,Liam Hemsworth,6,Nicolas Wright,103144286
New Line Cinema,50000000,Rawson Marshall Thurber,77440871,Dwayne Johnson,6,Ike Barinholtz,127440871
Scott Free Productions,8000000,Luke Scott,-4087948,Kate Mara,9,Seth W. Owen,3912052
Cross Creek Pictures,28000000,Burr Steers,-17092709,Lily James,2,Burr Steers,10907291
LightWorkers Media,100000000,Timur Bekmambetov,-73615319,Jack Huston,8,Lew Wallace,26384681
BenderSpink,31500000,Ariel Vromen,-17231467,Kevin Costner,4,Douglas Cook,14268533
George Films,28000000,Brad Furman,-12574130,Bryan Cranston,7,Ellen Sue Brown,15425870
Lionsgate,27500000,Dan Mazer,8037564,Robert De Niro,1,John Phillips,35537564
RatPac-Dune Entertainment,70000000,Nicholas Stoller,2655779,Andy Samberg,9,Nicholas Stoller,72655779
CG Cinéma,6000000,Olivier Assayas,-4694805,Kristen Stewart,3,Olivier Assayas,1305195
Broadway Video,25000000,Jared Hess,-7643106,Zach Galifianakis,9,Chris Bowman,17356894
Blackbird,3000000,Dan Kwan,1208879,Paul Dano,7,Daniel Scheinert,4208879
Columbia Pictures,38000000,J Blakeson,-3087018,Chloë Grace Moretz,1,Susannah Grant,34912982
Paramount Pictures,135000000,Dave Green,-52948399,Megan Fox,6,Josh Appelbaum,82051601
Millennium Films,60000000,Babak Najafi,2524260,Gerard Butler,3,Creighton Rothenberger,62524260
Allspark Pictures,9000000,Mike Flanagan,25904885,Elizabeth Reaser,10,Mike Flanagan,34904885
Good Universe,35000000,Nicholas Stoller,20291815,Seth Rogen,5,Andrew Jay Cohen,55291815
Laika Entertainment,60000000,Travis Knight,-11976912,Charlize Theron,8,Marc Haimes,48023088
Miramax,35000000,Sharon Maguire,-10747580,Renée Zellweger,9,Helen Fielding,24252420
Worldview Entertainment,20000000,John Hillcoat,-7373095,Casey Affleck,2,Matt Cook,12626905
Working Title Films,22000000,Ethan Coen,8080225,Josh Brolin,2,Joel Coen,30080225
Lakeshore Entertainment,8000000,William Brent Bell,27794166,Lauren Cohan,1,Stacey Menear,35794166
Verdi Productions,6000000,Ben Younger,-1152135,Miles Teller,11,Ben Younger,4847865
FilmNation Entertainment,30000000,Woody Allen,-18896795,Jesse Eisenberg,8,Woody Allen,11103205
Walt Disney Pictures,170000000,James Bobin,-92957619,Mia Wasikowska,5,Linda Woolverton,77042381
Qwerty Films,29000000,Stephen Frears,-1629893,Meryl Streep,8,Nicholas Martin,27370107
Warner Bros.,18000000,Jeff Nichols,-14292206,Michael Shannon,4,Jeff Nichols,3707794
Universal Pictures,10000000,James DeMonaco,69003080,Frank Grillo,7,James DeMonaco,79003080
Big Talk Productions,35000000,Louis Leterrier,-28135984,Sacha Baron Cohen,3,Sacha Baron Cohen,6864016
Blue Sky Studios,105000000,Mike Thurmeier,-40936992,Ray Romano,7,Michael J. Wilson,64063008
Panorama Films,50000000,Ben Stiller,-21151307,Ben Stiller,2,Justin Theroux,28848693
Annapurna Pictures,10000000,Richard Linklater,-6630569,Blake Jenner,4,Richard Linklater,3369431
Chartoff-Winkler Productions,40000000,Dennis Gansel,-18796740,Jason Statham,8,Lewis John Carlino,21203260
Disruption Entertainment,125000000,Chris Wedge,-91629834,Lucas Till,1,Derek Connolly,33370166
Amblin Partners,45000000,Josh Gordon,9730514,Jason Bateman,12,Justin Malen,54730514
A24,7000000,Mike Mills,-1336145,Annette Bening,1,Mike Mills,5663855
Walt Disney Pictures,140000000,Steven Spielberg,-84516230,Mark Rylance,7,Melissa Mathison,55483770
Walt Disney Pictures,80000000,Craig Gillespie,-52449265,Chris Pine,1,Scott Silver,27550735
Apatow Productions,20000000,Akiva Schaffer,-10606165,Andy Samberg,6,Andy Samberg,9393835
New Line Cinema,38000000,Christian Ditter,8813366,Dakota Johnson,2,Abby Kohn,46813366
EuropaCorp,10000000,Farren Blackburn,-3116049,Naomi Watts,11,Christina Hodson,6883951
Diablo Entertainment (II),250000,J.D. Dillard,3597290,Jacob Latimore,4,J.D. Dillard,3847290
Columbia Pictures,73000000,Clay Kaytis,34509366,Jason Sudeikis,5,Jon Vitti,107509366
Bow and Arrow Entertainment,1500000,Rob Zombie,-720180,Malcolm McDowell,9,Rob Zombie,779820
Cinelou Films,15000000,Taylor Hackford,-13341294,Robert De Niro,2,Art Linson,1658706
Bona Film Group,40000000,Ang Lee,-38278476,Joe Alwyn,11,Ben Fountain,1721524
Walt Disney Pictures,65000000,David Lowery,11204454,Bryce Dallas Howard,8,David Lowery,76204454
TriStar Pictures,27000000,Jodie Foster,14012075,George Clooney,5,Jamie Linden,41012075
Bluegrass Films,50000000,Gary Ross,-29241622,Matthew McConaughey,6,Gary Ross,20758378
Open Road Films (II),25000000,Garry Marshall,7463917,Jennifer Aniston,4,Anya Kochoff,32463917
New Regency Pictures,25000000,Warren Beatty,-21352164,Lily Collins,11,Warren Beatty,3647836
China Film Co.,145000000,Alessandro Carloni,-1471381,Jack Black,1,Jonathan Aibel,143528619
Raindog Films,9000000,Jeff Nichols,-1303902,Ruth Negga,11,Jeff Nichols,7696098
Tyler Perry Company The,20000000,Tyler Perry,53159525,Tyler Perry,10,Tyler Perry,73159525
Gramercy Pictures (I),10000000,Jason Zada,16583369,Natalie Dormer,1,Nick Antosca,26583369
Broadway Video,35000000,Glenn Ficarra,-11950425,Tina Fey,3,Robert Carlock,23049575
Dolphin Entertainment,10000000,Stewart Hendler,-6228603,Ben Winchell,10,Christopher Yost,3771397
Shooting Script Films,8000000,Roger Spottiswoode,-7964930,Luke Treadaway,11,James Bowen,35070
Pathé,14000000,Amma Asante,-10098698,David Oyelowo,2,Guy Hibbert,3901302
Bron Studios,8500000,Nate Parker,7358754,Nate Parker,10,Nate Parker,15858754
Lionsgate,5000000,Adam Wingard,15747013,James Allen McCune,9,Simon Barrett,20747013
X-Filme Creative Pool,30000000,Tom Tykwer,-25801874,Tom Hanks,6,Dave Eggers,4198126
Fuego Films,20000000,Jonathan Jakubowicz,-15288264,Edgar Ramírez,8,Jonathan Jakubowicz,4711736
EuropaCorp,30000000,Barry Sonnenfeld,-10362551,Kevin Spacey,8,Gwyn Lurie,19637449
42,21500000,Eran Creevy,-19219996,Nicholas Hoult,2,F. Scott Frazier,2280004
New Line Cinema,15000000,Peter Atencio,5566327,Keegan-Michael Key,4,Jordan Peele,20566327
Columbia Pictures,13000000,Patricia Riggen,48693523,Jennifer Garner,3,Christy Beam,61693523
Gary Sanchez Productions,29000000,Ben Falcone,34034755,Melissa McCarthy,4,Melissa McCarthy,63034755
Broad Green Pictures,26000000,Mark Waters,-8335027,Billy Bob Thornton,11,Johnny Rosenthal,17664973
Changing Film Productions,130000,Bank Tangjaitrong,-116443,John Matton,11,John Matton,13557
Cinelou Films,8000000,Bruce Beresford,-7314857,Eddie Murphy,9,Susan McMartin,685143
Hidden Empire Film Group,900000,Deon Taylor,8193856,Mike Epps,4,Nicole DeMasi,9093856
Demarest Films,15000000,D.J. Caruso,-12588420,Kate Beckinsale,9,Wentworth Miller,2411580
BBC Films,10000000,Mick Jackson,-5927774,Rachel Weisz,10,David Hare,4072226
StudioCanal,20000000,James Watkins,-19961000,Idris Elba,11,Andrew Baldwin,39000
Gold Circle Films,18000000,Kirk Jones,41573085,Nia Vardalos,3,Nia Vardalos,59573085
Perfect World Pictures (Beijing),17000000,David E. Talbert,24715860,Kimberly Elise,11,David E. Talbert,41715860
IM Global,5000000,Brad Peyton,-209427,Aaron Eckhart,12,Ronnie Christensen,4790573
Blumhouse Productions,4000000,Greg McLean,6732841,Kevin Bacon,5,Greg McLean,10732841
Westerly Films,3000000,Whit Stillman,11013564,Kate Beckinsale,6,Whit Stillman,14013564
Sycamore Pictures,3800000,John Krasinski,-2783128,Sharlto Copley,8,Jim Strouse,1016872
CBS Films,8500000,Steve Carr,11485196,Griffin Gluck,10,Chris Bowman,19985196
LD Entertainment,20000000,Kevin Reynolds,16874745,Joseph Fiennes,2,Kevin Reynolds,36874745
Warner Bros. Animation,3500000,Sam Liu,275000,Kevin Conroy,7,Brian Azzarello,3775000
